Date,Zone_ID,Intake_Water_Liters,Treated_Water_Liters,Supplied_Water_Liters,Estimated_Usage_Liters,No_of_Connections,Avg_LPCD,Leakage_Liters,Leakage_Percent
2024-01-01,Z0017,105795,103935,96545,27163,252,107.79,69382,71.86
2024-01-01,Z0050,101284,98646,96180,17042,164,103.92,79138,82.28
2024-01-01,Z0060,127194,124712,119268,11791,170,69.36,107477,90.11
2024-01-01,Z0076,106023,104893,101208,19611,224,87.55,81597,80.62
2024-01-01,Z0003,90769,87378,79767,25554,266,96.07,54213,67.96
2024-01-01,Z0109,92433,90218,83167,17147,280,61.24,66020,79.38
2024-01-01,Z0001,129188,127004,120449,15601,151,103.32,104848,87.05
2024-01-01,Z0011,109769,108748,101905,11229,187,60.05,90676,88.98
2024-01-01,Z0108,117480,112848,110374,16498,170,97.05,93876,85.05
2024-01-01,Z0043,115658,112100,108053,18938,207,91.49,89115,82.47
2024-01-01,Z0026,92747,90772,86966,18437,238,77.47,68529,78.8
2024-01-01,Z0093,90189,86184,81450,17469,208,83.99,63981,78.55
2024-01-01,Z0024,125773,124211,120312,14327,164,87.36,105985,88.09
2024-01-01,Z0019,91267,87388,83860,16590,200,82.95,67270,80.22
2024-01-01,Z0088,101394,96838,90948,18746,213,88.01,72202,79.39
2024-01-01,Z0077,120740,116852,109459,20164,200,100.82,89295,81.58
2024-01-01,Z0040,100627,99027,94664,14185,222,63.9,80479,85.02
2024-01-01,Z0107,98433,95392,90568,32744,281,116.53,57824,63.85
2024-01-01,Z0008,113897,110285,106922,17685,163,108.5,89237,83.46
2024-01-01,Z0009,113483,111005,106449,9631,158,60.96,96818,90.95
2024-01-01,Z0111,107159,106125,100973,28192,279,101.05,72781,72.08
2024-01-01,Z0103,116531,113946,108003,26260,260,101.0,81743,75.69
2024-01-01,Z0061,113939,109866,106845,9743,157,62.06,97102,90.88
2024-01-01,Z0028,101653,98040,90815,17371,230,75.53,73444,80.87
2024-01-01,Z0029,99692,97990,90315,26645,253,105.32,63670,70.5
2024-01-01,Z0037,90161,88960,84979,20511,283,72.48,64468,75.86
2024-01-01,Z0074,123763,120446,113535,10876,153,71.09,102659,90.42
2024-01-01,Z0051,101534,100079,94281,31420,295,106.51,62861,66.67
2024-01-01,Z0098,115851,113835,111498,16893,163,103.64,94605,84.85
2024-01-01,Z0073,107262,105186,98299,10710,164,65.31,87589,89.1
2024-01-01,Z0083,102185,98921,92062,20916,189,110.67,71146,77.28
2024-01-01,Z0053,129099,127720,125228,21339,231,92.38,103889,82.96
2024-01-01,Z0104,129976,127796,123734,14083,173,81.41,109651,88.62
2024-01-01,Z0045,92568,90201,82953,20900,273,76.56,62053,74.81
2024-01-01,Z0105,92027,88332,84837,11466,164,69.92,73371,86.48
2024-01-01,Z0089,95258,92736,90345,28371,238,119.21,61974,68.6
2024-01-01,Z0069,103986,102568,96094,19834,237,83.69,76260,79.36
2024-01-01,Z0002,128660,124099,119821,17194,285,60.33,102627,85.65
2024-01-01,Z0046,128952,124853,122653,20715,288,71.93,101938,83.11
2024-01-01,Z0034,120535,118756,113652,29565,285,103.74,84087,73.99
2024-01-01,Z0025,113599,112097,107643,17537,182,96.36,90106,83.71
2024-01-01,Z0100,101837,99086,96282,21831,190,114.9,74451,77.33
2024-01-01,Z0091,120818,117087,109096,19220,221,86.97,89876,82.38
2024-01-01,Z0006,100965,98395,91339,11613,182,63.81,79726,87.29
2024-01-01,Z0062,122482,118822,111241,16776,211,79.51,94465,84.92
2024-01-01,Z0092,117266,112426,109398,23679,248,95.48,85719,78.36
2024-01-01,Z0059,123270,119456,112963,16252,184,88.33,96711,85.61
2024-01-01,Z0110,115446,111604,105116,29575,250,118.3,75541,71.86
2024-01-01,Z0068,90206,88168,80191,29582,280,105.65,50609,63.11
2024-01-01,Z0101,113419,110935,108072,26082,291,89.63,81990,75.87
2024-01-01,Z0018,112403,109646,105968,29355,286,102.64,76613,72.3
2024-01-01,Z0070,123827,120255,112976,14705,239,61.53,98271,86.98
2024-01-01,Z0065,106198,103476,98162,24115,212,113.75,74047,75.43
2024-01-01,Z0058,112299,108674,103945,18853,201,93.8,85092,81.86
2024-01-01,Z0067,92693,90898,83751,32160,281,114.45,51591,61.6
2024-01-01,Z0048,93627,91264,87283,30756,292,105.33,56527,64.76
2024-01-01,Z0031,111834,109171,105642,21565,185,116.57,84077,79.59
2024-01-01,Z0086,100230,95811,88219,17025,220,77.39,71194,80.7
2024-01-01,Z0052,113776,111368,103872,26515,235,112.83,77357,74.47
2024-01-01,Z0030,91306,87626,82951,15081,194,77.74,67870,81.82
2024-01-01,Z0080,99474,95044,92335,24731,283,87.39,67604,73.22
2024-01-01,Z0084,111959,109525,102781,18295,257,71.19,84486,82.2
2024-01-01,Z0032,93748,89452,82099,20227,179,113.0,61872,75.36
2024-01-01,Z0078,90663,87665,82220,30040,277,108.45,52180,63.46
2024-01-01,Z0005,120303,117808,112504,19612,241,81.38,92892,82.57
2024-01-01,Z0007,129353,127790,124499,20483,278,73.68,104016,83.55
2024-01-01,Z0012,113938,109754,106118,29451,270,109.08,76667,72.25
2024-01-01,Z0021,110080,106081,100929,9183,152,60.42,91746,90.9
2024-01-01,Z0039,116736,115735,108998,25479,286,89.09,83519,76.62
2024-01-01,Z0054,90854,88095,82621,15232,200,76.16,67389,81.56
2024-01-01,Z0047,111556,108849,104072,16513,208,79.39,87559,84.13
2024-01-01,Z0016,128559,125826,118291,22905,245,93.49,95386,80.64
2024-01-01,Z0014,94931,90421,88219,16739,262,63.89,71480,81.03
2024-01-01,Z0004,102688,100922,94533,15036,201,74.81,79497,84.09
2024-01-01,Z0015,92327,87419,82488,16888,188,89.83,65600,79.53
2024-01-01,Z0106,90197,86168,82238,18049,262,68.89,64189,78.05
2024-01-01,Z0056,105087,101896,99288,17482,230,76.01,81806,82.39
2024-01-01,Z0102,117848,115701,109419,13614,151,90.16,95805,87.56
2024-01-01,Z0013,105708,102914,100255,12581,203,61.98,87674,87.45
2024-01-01,Z0010,92811,88809,85440,20674,278,74.37,64766,75.8
2024-01-01,Z0094,124754,122220,120074,25628,279,91.86,94446,78.66
2024-01-01,Z0044,101411,97500,93766,14072,217,64.85,79694,84.99
2024-01-01,Z0066,108227,106739,101763,20272,272,74.53,81491,80.08
2024-01-01,Z0097,108343,105680,101295,15347,187,82.07,85948,84.85
2024-01-01,Z0087,101111,99471,95669,31537,265,119.01,64132,67.04
2024-01-01,Z0071,98155,94635,87101,31389,288,108.99,55712,63.96
2024-01-01,Z0112,110445,106076,98346,32265,293,110.12,66081,67.19
2024-01-01,Z0038,106646,103859,101236,24703,273,90.49,76533,75.6
2024-01-01,Z0085,106371,101728,94752,26983,242,111.5,67769,71.52
2024-01-01,Z0035,92049,88105,80682,30390,296,102.67,50292,62.33
2024-01-01,Z0090,110932,106824,99545,23952,296,80.92,75593,75.94
2024-01-01,Z0063,97158,94102,88932,23402,201,116.43,65530,73.69
2024-01-01,Z0095,105151,101896,98742,25226,277,91.07,73516,74.45
2024-01-01,Z0027,94499,91300,86109,17267,253,68.25,68842,79.95
2024-01-01,Z0023,102183,100556,93874,14416,191,75.48,79458,84.64
2024-01-01,Z0022,122711,120268,116823,31945,293,109.03,84878,72.66
2024-01-01,Z0096,92557,90061,87963,15810,209,75.65,72153,82.03
2024-01-01,Z0036,92200,89316,84355,18234,278,65.59,66121,78.38
2024-01-01,Z0041,111357,110020,104243,27021,289,93.5,77222,74.08
2024-01-01,Z0081,92869,88635,82844,12123,158,76.73,70721,85.37
2024-01-01,Z0082,118643,117483,109784,30653,296,103.56,79131,72.08
2024-01-01,Z0079,113328,111931,108631,31186,280,111.38,77445,71.29
2024-01-01,Z0033,111295,106308,102781,21678,203,106.79,81103,78.91
2024-01-01,Z0020,112399,109984,102730,17238,265,65.05,85492,83.22
2024-01-01,Z0064,123986,122586,115851,24386,253,96.39,91465,78.95
2024-01-01,Z0099,94555,92601,86036,17249,261,66.09,68787,79.95
2024-01-01,Z0075,109830,107785,104092,29368,248,118.42,74724,71.79
2024-01-01,Z0042,104373,101096,95660,20546,295,69.65,75114,78.52
2024-01-01,Z0057,98754,95269,87374,20591,231,89.14,66783,76.43
2024-01-01,Z0055,109738,106664,104439,16107,217,74.23,88332,84.58
2024-01-01,Z0049,122352,119021,116062,12024,170,70.73,104038,89.64
2024-01-01,Z0072,95600,94148,89081,28988,277,104.65,60093,67.46
2024-01-02,Z0017,99007,97349,90707,23073,294,78.48,67634,74.56
2024-01-02,Z0050,98208,93965,90722,25919,264,98.18,64803,71.43
2024-01-02,Z0060,108589,105065,101996,12763,171,74.64,89233,87.49
2024-01-02,Z0076,126212,122647,114783,22202,187,118.73,92581,80.66
2024-01-02,Z0003,123828,120501,115081,22704,200,113.52,92377,80.27
2024-01-02,Z0109,121216,119915,113639,15146,176,86.06,98493,86.67
2024-01-02,Z0001,90699,88707,85568,15327,170,90.16,70241,82.09
2024-01-02,Z0011,90190,86890,83910,17724,177,100.14,66186,78.88
2024-01-02,Z0108,125743,122737,119553,18889,210,89.95,100664,84.2
2024-01-02,Z0043,109778,108651,104586,9403,153,61.46,95183,91.01
2024-01-02,Z0026,124584,121826,119257,12398,198,62.62,106859,89.6
2024-01-02,Z0093,128210,125315,120582,22403,195,114.89,98179,81.42
2024-01-02,Z0024,126631,125006,118992,26005,248,104.86,92987,78.15
2024-01-02,Z0019,101093,98407,93398,21520,186,115.7,71878,76.96
2024-01-02,Z0088,106538,103001,99592,23010,195,118.0,76582,76.9
2024-01-02,Z0077,90784,86609,80268,29467,248,118.82,50801,63.29
2024-01-02,Z0040,129974,127474,119673,20582,265,77.67,99091,82.8
2024-01-02,Z0107,109190,107653,99667,15156,216,70.17,84511,84.79
2024-01-02,Z0008,119592,116137,113613,14560,174,83.68,99053,87.18
2024-01-02,Z0009,113355,110826,105876,20657,203,101.76,85219,80.49
2024-01-02,Z0111,114376,113341,106561,16247,253,64.22,90314,84.75
2024-01-02,Z0103,92368,87521,81026,25484,263,96.9,55542,68.55
2024-01-02,Z0061,100893,98922,95756,19157,235,81.52,76599,79.99
2024-01-02,Z0028,103403,98978,92049,25143,276,91.1,66906,72.69
2024-01-02,Z0029,100966,97984,95131,22138,279,79.35,72993,76.73
2024-01-02,Z0037,118312,113543,110969,25760,253,101.82,85209,76.79
2024-01-02,Z0074,112677,109316,105601,19685,192,102.53,85916,81.36
2024-01-02,Z0051,94777,92940,87086,14592,188,77.62,72494,83.24
2024-01-02,Z0098,119749,115699,111208,19006,175,108.61,92202,82.91
2024-01-02,Z0073,117236,113196,108072,10513,162,64.9,97559,90.27
2024-01-02,Z0083,93051,88360,86356,25585,284,90.09,60771,70.37
2024-01-02,Z0053,111606,109387,102518,16731,169,99.0,85787,83.68
2024-01-02,Z0104,90876,88885,82743,18473,293,63.05,64270,77.67
2024-01-02,Z0045,105202,101332,94968,21193,264,80.28,73775,77.68
2024-01-02,Z0105,127233,125598,118373,22829,241,94.73,95544,80.71
2024-01-02,Z0089,108077,105395,98643,17140,181,94.7,81503,82.62
2024-01-02,Z0069,98311,96481,88575,18727,235,79.69,69848,78.86
2024-01-02,Z0002,118251,116170,112801,25208,212,118.91,87593,77.65
2024-01-02,Z0046,115316,110771,108655,28539,299,95.45,80116,73.73
2024-01-02,Z0034,95949,92111,88961,17629,235,75.02,71332,80.18
2024-01-02,Z0025,113944,111013,108001,17125,219,78.2,90876,84.14
2024-01-02,Z0100,91081,89448,86936,22832,250,91.33,64104,73.74
2024-01-02,Z0091,97805,95664,93105,15410,202,76.29,77695,83.45
2024-01-02,Z0006,110056,108569,101577,25024,257,97.37,76553,75.36
2024-01-02,Z0062,93343,91131,85061,9780,155,63.1,75281,88.5
2024-01-02,Z0092,119375,116905,114325,22440,265,84.68,91885,80.37
2024-01-02,Z0059,98130,93983,87734,24366,248,98.25,63368,72.23
2024-01-02,Z0110,91679,87173,80081,13659,201,67.96,66422,82.94
2024-01-02,Z0068,97253,93509,88153,23927,263,90.98,64226,72.86
2024-01-02,Z0101,99435,97343,92225,31882,296,107.71,60343,65.43
2024-01-02,Z0018,103296,100155,92286,18234,212,86.01,74052,80.24
2024-01-02,Z0070,103245,99186,92638,13394,207,64.71,79244,85.54
2024-01-02,Z0065,119899,115940,111675,17250,266,64.85,94425,84.55
2024-01-02,Z0058,125247,121859,115213,28085,276,101.76,87128,75.62
2024-01-02,Z0067,116211,113899,110142,19571,278,70.4,90571,82.23
2024-01-02,Z0048,127220,124150,116269,12981,150,86.54,103288,88.84
2024-01-02,Z0031,113049,110268,105419,22772,245,92.95,82647,78.4
2024-01-02,Z0086,113289,108559,104070,13981,197,70.97,90089,86.57
2024-01-02,Z0052,99823,96007,92992,26147,266,98.3,66845,71.88
2024-01-02,Z0030,99540,98025,92938,21080,218,96.7,71858,77.32
2024-01-02,Z0080,128646,125341,118749,21141,225,93.96,97608,82.2
2024-01-02,Z0084,115471,112264,106718,14302,235,60.86,92416,86.6
2024-01-02,Z0032,90851,88164,84233,14311,218,65.65,69922,83.01
2024-01-02,Z0078,96833,92087,87660,27053,243,111.33,60607,69.14
2024-01-02,Z0005,116144,114188,109450,19299,293,65.87,90151,82.37
2024-01-02,Z0007,118074,115438,108051,20687,234,88.41,87364,80.85
2024-01-02,Z0012,122320,119880,112593,15994,182,87.88,96599,85.79
2024-01-02,Z0021,93913,91847,85467,20977,250,83.91,64490,75.46
2024-01-02,Z0039,110491,107861,102488,18595,159,116.95,83893,81.86
2024-01-02,Z0054,102161,97837,93291,15617,249,62.72,77674,83.26
2024-01-02,Z0047,124850,121076,116180,27996,287,97.55,88184,75.9
2024-01-02,Z0016,118761,116986,113361,27290,245,111.39,86071,75.93
2024-01-02,Z0014,101261,99844,97730,22026,218,101.04,75704,77.46
2024-01-02,Z0004,110358,106091,103266,10597,165,64.23,92669,89.74
2024-01-02,Z0015,114052,111403,107887,9300,151,61.59,98587,91.38
2024-01-02,Z0106,101338,99926,97198,27195,277,98.18,70003,72.02
2024-01-02,Z0056,113548,109740,107065,22025,233,94.53,85040,79.43
2024-01-02,Z0102,128756,125252,120285,18484,273,67.71,101801,84.63
2024-01-02,Z0013,107506,104935,97862,24390,250,97.56,73472,75.08
2024-01-02,Z0010,95104,91961,88274,25181,214,117.67,63093,71.47
2024-01-02,Z0094,113190,108929,102797,16145,223,72.4,86652,84.29
2024-01-02,Z0044,126208,121442,113798,11420,178,64.16,102378,89.96
2024-01-02,Z0066,92914,91042,83125,20164,244,82.64,62961,75.74
2024-01-02,Z0097,104397,102802,94803,14754,184,80.19,80049,84.44
2024-01-02,Z0087,90728,88363,81871,18914,239,79.14,62957,76.9
2024-01-02,Z0071,90698,86608,78877,19225,239,80.44,59652,75.63
2024-01-02,Z0112,106779,103287,97116,20304,264,76.91,76812,79.09
2024-01-02,Z0038,94360,90858,87039,21072,207,101.8,65967,75.79
2024-01-02,Z0085,107101,103319,96373,25233,224,112.65,71140,73.82
2024-01-02,Z0035,95486,94343,87363,20068,170,118.05,67295,77.03
2024-01-02,Z0090,127259,123163,118225,24512,287,85.41,93713,79.27
2024-01-02,Z0063,111972,107417,101781,21020,248,84.76,80761,79.35
2024-01-02,Z0095,91167,87551,84489,19710,245,80.45,64779,76.67
2024-01-02,Z0027,108540,103776,96615,13823,186,74.32,82792,85.69
2024-01-02,Z0023,111689,107707,102413,16911,162,104.39,85502,83.49
2024-01-02,Z0022,127497,125341,118007,16415,248,66.19,101592,86.09
2024-01-02,Z0096,98924,97690,90844,15281,166,92.06,75563,83.18
2024-01-02,Z0036,96731,92651,89698,25534,233,109.59,64164,71.53
2024-01-02,Z0041,125307,121347,116023,18297,235,77.86,97726,84.23
2024-01-02,Z0081,91542,89345,81573,14002,168,83.35,67571,82.84
2024-01-02,Z0082,129081,126665,121672,33960,289,117.51,87712,72.09
2024-01-02,Z0079,113322,109641,106424,19382,296,65.48,87042,81.79
2024-01-02,Z0033,107924,104848,99612,20709,177,117.0,78903,79.21
2024-01-02,Z0020,116962,112243,104628,24639,277,88.95,79989,76.45
2024-01-02,Z0064,116432,114067,111568,16900,260,65.0,94668,84.85
2024-01-02,Z0099,116256,114746,108434,16914,218,77.59,91520,84.4
2024-01-02,Z0075,91324,89169,85342,16220,174,93.22,69122,80.99
2024-01-02,Z0042,125909,121586,116100,21712,202,107.49,94388,81.3
2024-01-02,Z0057,124578,121086,116163,13762,206,66.81,102401,88.15
2024-01-02,Z0055,128069,124855,118669,22623,191,118.45,96046,80.94
2024-01-02,Z0049,115289,112408,106806,27054,291,92.97,79752,74.67
2024-01-02,Z0072,118710,114513,108991,29390,282,104.22,79601,73.03
2024-01-03,Z0017,110652,109000,102151,15012,224,67.02,87139,85.3
2024-01-03,Z0050,99435,94726,91645,22788,225,101.28,68857,75.13
2024-01-03,Z0060,120355,116832,114377,19424,294,66.07,94953,83.02
2024-01-03,Z0076,103116,101222,97838,13348,156,85.57,84490,86.36
2024-01-03,Z0003,129298,126302,120017,31262,286,109.31,88755,73.95
2024-01-03,Z0109,90504,88290,84759,18644,271,68.8,66115,78.0
2024-01-03,Z0001,118016,113536,110713,11586,178,65.09,99127,89.54
2024-01-03,Z0011,107312,105379,98143,22012,232,94.88,76131,77.57
2024-01-03,Z0108,92105,87478,80698,21217,258,82.24,59481,73.71
2024-01-03,Z0043,112700,109848,102938,34348,294,116.83,68590,66.63
2024-01-03,Z0026,110559,106626,101342,20408,194,105.2,80934,79.86
2024-01-03,Z0093,101003,98751,90956,22445,219,102.49,68511,75.32
2024-01-03,Z0024,115826,113144,105493,17913,168,106.63,87580,83.02
2024-01-03,Z0019,96190,93934,88558,17980,240,74.92,70578,79.7
2024-01-03,Z0088,128413,126247,120761,11200,168,66.67,109561,90.73
2024-01-03,Z0077,93330,89627,87157,24449,290,84.31,62708,71.95
2024-01-03,Z0040,114504,110486,103355,17429,275,63.38,85926,83.14
2024-01-03,Z0107,124121,120338,115507,22967,210,109.37,92540,80.12
2024-01-03,Z0008,111447,110090,105071,15129,150,100.86,89942,85.6
2024-01-03,Z0009,113959,112292,105824,28372,241,117.73,77452,73.19
2024-01-03,Z0111,119703,117558,110091,17022,262,64.97,93069,84.54
2024-01-03,Z0103,126487,122742,120203,31332,266,117.79,88871,73.93
2024-01-03,Z0061,117355,115487,109351,22903,193,118.67,86448,79.06
2024-01-03,Z0028,94835,90060,82740,16665,210,79.36,66075,79.86
2024-01-03,Z0029,103216,100180,95672,20990,229,91.66,74682,78.06
2024-01-03,Z0037,125547,121748,118824,34975,296,118.16,83849,70.57
2024-01-03,Z0074,117532,114951,109627,20641,295,69.97,88986,81.17
2024-01-03,Z0051,95713,91783,89528,20144,198,101.74,69384,77.5
2024-01-03,Z0098,94804,91966,88022,14647,150,97.65,73375,83.36
2024-01-03,Z0073,90009,86138,83341,22174,267,83.05,61167,73.39
2024-01-03,Z0083,113793,109471,102499,18920,161,117.52,83579,81.54
2024-01-03,Z0053,127892,123702,120687,18714,165,113.42,101973,84.49
2024-01-03,Z0104,117712,114519,112296,20386,266,76.64,91910,81.85
2024-01-03,Z0045,113833,112771,105435,23813,241,98.81,81622,77.41
2024-01-03,Z0105,110309,106435,99651,23142,285,81.2,76509,76.78
2024-01-03,Z0089,110384,107751,103599,11444,177,64.66,92155,88.95
2024-01-03,Z0069,98702,97318,94914,14363,190,75.6,80551,84.87
2024-01-03,Z0002,119189,117714,113714,22576,294,76.79,91138,80.15
2024-01-03,Z0046,122606,119938,111949,33251,290,114.66,78698,70.3
2024-01-03,Z0034,105106,102646,97010,33108,283,116.99,63902,65.87
2024-01-03,Z0025,100916,99203,93025,22569,196,115.15,70456,75.74
2024-01-03,Z0100,103456,99300,91303,18437,159,115.96,72866,79.81
2024-01-03,Z0091,124816,123766,116986,18031,258,69.89,98955,84.59
2024-01-03,Z0006,107100,102257,94692,19412,182,106.66,75280,79.5
2024-01-03,Z0062,94544,92664,86081,35175,295,119.24,50906,59.14
2024-01-03,Z0092,116657,112238,108664,15304,160,95.65,93360,85.92
2024-01-03,Z0059,104489,103240,100567,17718,212,83.58,82849,82.38
2024-01-03,Z0110,118538,114161,107798,22990,208,110.53,84808,78.67
2024-01-03,Z0068,98427,97039,92002,15365,247,62.21,76637,83.3
2024-01-03,Z0101,114285,112523,108675,16907,278,60.82,91768,84.44
2024-01-03,Z0018,112928,111305,106491,22823,204,111.88,83668,78.57
2024-01-03,Z0070,109758,105792,100514,25617,244,104.99,74897,74.51
2024-01-03,Z0065,91252,87352,81371,14186,152,93.33,67185,82.57
2024-01-03,Z0058,127441,124319,117789,23571,202,116.69,94218,79.99
2024-01-03,Z0067,105781,101006,94147,17362,232,74.84,76785,81.56
2024-01-03,Z0048,129649,125796,122467,16412,227,72.3,106055,86.6
2024-01-03,Z0031,98017,94172,90814,17586,150,117.24,73228,80.64
2024-01-03,Z0086,113386,109904,103362,11279,153,73.72,92083,89.09
2024-01-03,Z0052,100209,97878,91534,27620,262,105.42,63914,69.83
2024-01-03,Z0030,121703,119345,112230,14912,183,81.49,97318,86.71
2024-01-03,Z0080,94637,92879,87702,13553,221,61.33,74149,84.55
2024-01-03,Z0084,127660,123713,121576,29337,267,109.88,92239,75.87
2024-01-03,Z0032,109856,107503,102671,22114,199,111.13,80557,78.46
2024-01-03,Z0078,109963,107088,102057,23970,203,118.08,78087,76.51
2024-01-03,Z0005,126932,123339,115770,19652,206,95.4,96118,83.02
2024-01-03,Z0007,94300,91127,85309,16705,196,85.23,68604,80.42
2024-01-03,Z0012,102015,99109,96349,23016,234,98.36,73333,76.11
2024-01-03,Z0021,114214,109960,104515,16302,224,72.78,88213,84.4
2024-01-03,Z0039,112415,107824,104925,18043,187,96.49,86882,82.8
2024-01-03,Z0054,108271,104005,101339,19295,231,83.53,82044,80.96
2024-01-03,Z0047,94188,92517,88548,15710,240,65.46,72838,82.26
2024-01-03,Z0016,118732,115051,109929,18662,201,92.85,91267,83.02
2024-01-03,Z0014,113954,109094,101970,19104,228,83.79,82866,81.27
2024-01-03,Z0004,111969,110366,103589,28493,255,111.74,75096,72.49
2024-01-03,Z0015,126668,123087,115563,30396,282,107.79,85167,73.7
2024-01-03,Z0106,129749,125165,122642,33177,287,115.6,89465,72.95
2024-01-03,Z0056,108777,104660,100067,23669,223,106.14,76398,76.35
2024-01-03,Z0102,116329,113493,109197,20399,233,87.55,88798,81.32
2024-01-03,Z0013,112574,110430,106169,17796,183,97.25,88373,83.24
2024-01-03,Z0010,100478,98399,92197,26950,275,98.0,65247,70.77
2024-01-03,Z0094,109262,108215,102571,24351,264,92.24,78220,76.26
2024-01-03,Z0044,94432,92383,85007,15826,229,69.11,69181,81.38
2024-01-03,Z0066,104178,101902,94091,27196,267,101.86,66895,71.1
2024-01-03,Z0097,90302,88664,86609,19925,281,70.91,66684,76.99
2024-01-03,Z0087,98717,97244,91121,19802,174,113.81,71319,78.27
2024-01-03,Z0071,98150,95025,89738,28650,242,118.39,61088,68.07
2024-01-03,Z0112,106748,103035,96414,15023,210,71.54,81391,84.42
2024-01-03,Z0038,105034,102699,95721,32355,296,109.31,63366,66.2
2024-01-03,Z0085,95126,93100,89454,19487,241,80.86,69967,78.22
2024-01-03,Z0035,107302,103505,95635,11169,171,65.32,84466,88.32
2024-01-03,Z0090,91531,87186,83280,13810,150,92.07,69470,83.42
2024-01-03,Z0063,125854,123639,115889,11653,161,72.38,104236,89.94
2024-01-03,Z0095,100267,98554,95492,12392,183,67.72,83100,87.02
2024-01-03,Z0027,119926,116793,114668,15382,194,79.29,99286,86.59
2024-01-03,Z0023,94632,91440,85844,18893,175,107.96,66951,77.99
2024-01-03,Z0022,96168,93565,91499,27342,270,101.27,64157,70.12
2024-01-03,Z0096,106616,103460,100291,23044,205,112.41,77247,77.02
2024-01-03,Z0036,116734,113459,107253,17519,212,82.64,89734,83.67
2024-01-03,Z0041,116069,112988,106270,17620,230,76.61,88650,83.42
2024-01-03,Z0081,97943,93503,89031,9760,150,65.07,79271,89.04
2024-01-03,Z0082,109123,106818,103057,17625,248,71.07,85432,82.9
2024-01-03,Z0079,100167,96805,93929,16117,196,82.23,77812,82.84
2024-01-03,Z0033,93812,89364,86052,15827,163,97.1,70225,81.61
2024-01-03,Z0020,117285,113961,110228,19919,227,87.75,90309,81.93
2024-01-03,Z0064,91605,89079,84516,16444,258,63.74,68072,80.54
2024-01-03,Z0099,101613,97723,92206,13937,205,67.99,78269,84.88
2024-01-03,Z0075,100589,97959,92224,17283,152,113.71,74941,81.26
2024-01-03,Z0042,117446,115286,108432,23534,256,91.93,84898,78.3
2024-01-03,Z0057,114818,111228,108165,14502,167,86.84,93663,86.59
2024-01-03,Z0055,94324,90729,87810,19681,264,74.55,68129,77.59
2024-01-03,Z0049,128110,127105,124638,22147,268,82.64,102491,82.23
2024-01-03,Z0072,104043,102969,100966,14912,188,79.32,86054,85.23
2024-01-04,Z0017,112350,110705,108588,18717,235,79.65,89871,82.76
2024-01-04,Z0050,108935,105914,98872,14280,193,73.99,84592,85.56
2024-01-04,Z0060,128328,127135,124289,15490,162,95.62,108799,87.54
2024-01-04,Z0076,100954,98539,90985,17644,217,81.31,73341,80.61
2024-01-04,Z0003,112700,108329,100565,22902,258,88.77,77663,77.23
2024-01-04,Z0109,96469,94036,90895,27094,260,104.21,63801,70.19
2024-01-04,Z0001,116386,114663,112439,27229,260,104.73,85210,75.78
2024-01-04,Z0011,126976,123789,117135,24593,262,93.87,92542,79.0
2024-01-04,Z0108,92048,88911,82162,14712,191,77.03,67450,82.09
2024-01-04,Z0043,91828,88911,82677,17666,155,113.98,65011,78.63
2024-01-04,Z0026,122254,117315,113289,20075,213,94.25,93214,82.28
2024-01-04,Z0093,110128,108227,101442,24791,208,119.19,76651,75.56
2024-01-04,Z0024,90009,88749,85076,20042,270,74.23,65034,76.44
2024-01-04,Z0019,92219,88274,84214,21982,299,73.52,62232,73.9
2024-01-04,Z0088,95287,90574,86955,16372,219,74.76,70583,81.17
2024-01-04,Z0077,98512,96170,88438,16990,153,111.05,71448,80.79
2024-01-04,Z0040,109216,105392,101398,22861,211,108.35,78537,77.45
2024-01-04,Z0107,117534,114591,110553,22550,204,110.54,88003,79.6
2024-01-04,Z0008,126258,121581,118463,25611,280,91.47,92852,78.38
2024-01-04,Z0009,107988,104623,98596,19243,189,101.82,79353,80.48
2024-01-04,Z0111,90235,87266,80837,12999,155,83.87,67838,83.92
2024-01-04,Z0103,91908,90533,85003,25072,224,111.93,59931,70.5
2024-01-04,Z0061,95256,91621,88051,33535,283,118.5,54516,61.91
2024-01-04,Z0028,95415,91024,86059,17070,243,70.25,68989,80.16
2024-01-04,Z0029,95951,93579,87729,24425,211,115.76,63304,72.16
2024-01-04,Z0037,120523,116678,113364,20998,228,92.1,92366,81.48
2024-01-04,Z0074,111204,106968,102070,13440,175,76.8,88630,86.83
2024-01-04,Z0051,113930,112853,108232,13953,193,72.3,94279,87.11
2024-01-04,Z0098,110611,109011,101143,27410,267,102.66,73733,72.9
2024-01-04,Z0073,107449,104313,99864,12597,169,74.54,87267,87.39
2024-01-04,Z0083,99510,97895,92298,20076,196,102.43,72222,78.25
2024-01-04,Z0053,129711,124949,116965,22500,291,77.32,94465,80.76
2024-01-04,Z0104,111526,109952,105762,16808,186,90.37,88954,84.11
2024-01-04,Z0045,99184,95472,91280,19730,249,79.24,71550,78.39
2024-01-04,Z0105,124016,119962,113364,9592,152,63.11,103772,91.54
2024-01-04,Z0089,108381,106561,100874,14774,159,92.92,86100,85.35
2024-01-04,Z0069,116727,112617,108647,34267,287,119.4,74380,68.46
2024-01-04,Z0002,117202,113764,110562,16373,162,101.07,94189,85.19
2024-01-04,Z0046,114519,110918,103351,17540,233,75.28,85811,83.03
2024-01-04,Z0034,105374,102728,94940,15040,250,60.16,79900,84.16
2024-01-04,Z0025,95408,92373,89896,15126,158,95.74,74770,83.17
2024-01-04,Z0100,99446,97524,95105,15840,187,84.71,79265,83.34
2024-01-04,Z0091,100789,96277,93157,16135,243,66.4,77022,82.68
2024-01-04,Z0006,122154,120204,115868,23945,218,109.84,91923,79.33
2024-01-04,Z0062,128141,124898,120253,26327,227,115.98,93926,78.11
2024-01-04,Z0092,122265,120749,112995,20677,286,72.3,92318,81.7
2024-01-04,Z0059,113710,111896,103900,21268,184,115.59,82632,79.53
2024-01-04,Z0110,96359,92364,87136,20122,213,94.47,67014,76.91
2024-01-04,Z0068,110103,105771,100543,22767,213,106.89,77776,77.36
2024-01-04,Z0101,104382,101011,96120,17235,160,107.72,78885,82.07
2024-01-04,Z0018,93756,92627,90533,17599,163,107.97,72934,80.56
2024-01-04,Z0070,125442,121640,117685,12854,184,69.86,104831,89.08
2024-01-04,Z0065,123561,120727,116611,11417,154,74.14,105194,90.21
2024-01-04,Z0058,95779,94769,89444,20743,227,91.38,68701,76.81
2024-01-04,Z0067,104153,100234,95637,22190,281,78.97,73447,76.8
2024-01-04,Z0048,102999,99929,97115,15958,191,83.55,81157,83.57
2024-01-04,Z0031,100541,99179,94736,16465,189,87.12,78271,82.62
2024-01-04,Z0086,100457,97269,92264,20902,253,82.62,71362,77.35
2024-01-04,Z0052,107368,103328,99689,21393,274,78.08,78296,78.54
2024-01-04,Z0030,123595,119865,114334,14847,172,86.32,99487,87.01
2024-01-04,Z0080,129915,128560,121117,33507,294,113.97,87610,72.34
2024-01-04,Z0084,128727,127601,122424,23106,202,114.39,99318,81.13
2024-01-04,Z0032,117632,116029,110580,12597,188,67.01,97983,88.61
2024-01-04,Z0078,110530,106430,100897,22631,283,79.97,78266,77.57
2024-01-04,Z0005,93368,88571,81045,13056,191,68.36,67989,83.89
2024-01-04,Z0007,124560,120699,112967,18486,164,112.72,94481,83.64
2024-01-04,Z0012,126244,121827,118182,16745,182,92.01,101437,85.83
2024-01-04,Z0021,109256,105184,101330,19661,187,105.14,81669,80.6
2024-01-04,Z0039,127430,124012,116981,11285,182,62.01,105696,90.35
2024-01-04,Z0054,92708,88206,84874,24167,235,102.84,60707,71.53
2024-01-04,Z0047,121880,120679,115172,17341,154,112.61,97831,84.94
2024-01-04,Z0016,129224,128108,121076,16277,246,66.17,104799,86.56
2024-01-04,Z0014,115150,111859,109323,19325,290,66.64,89998,82.32
2024-01-04,Z0004,124393,121271,118886,17453,258,67.65,101433,85.32
2024-01-04,Z0015,98070,93789,91315,17685,164,107.84,73630,80.63
2024-01-04,Z0106,126368,122681,115647,13733,154,89.18,101914,88.13
2024-01-04,Z0056,94971,93209,85911,22424,217,103.34,63487,73.9
2024-01-04,Z0102,91990,89787,82982,16943,279,60.73,66039,79.58
2024-01-04,Z0013,109956,107077,99797,26832,264,101.64,72965,73.11
2024-01-04,Z0010,127148,126086,118988,19049,185,102.97,99939,83.99
2024-01-04,Z0094,94757,91044,86841,14210,176,80.74,72631,83.64
2024-01-04,Z0044,106241,103749,98629,18806,160,117.54,79823,80.93
2024-01-04,Z0066,94944,92837,87405,24035,253,95.0,63370,72.5
2024-01-04,Z0097,127011,122310,119969,15087,172,87.72,104882,87.42
2024-01-04,Z0087,121195,119109,115385,18895,195,96.9,96490,83.62
2024-01-04,Z0071,110806,108014,104255,19821,290,68.35,84434,80.99
2024-01-04,Z0112,116838,113356,110405,26928,260,103.57,83477,75.61
2024-01-04,Z0038,117965,114886,110169,28667,249,115.13,81502,73.98
2024-01-04,Z0085,117952,116524,113024,32528,282,115.35,80496,71.22
2024-01-04,Z0035,114861,110646,105151,21896,221,99.08,83255,79.18
2024-01-04,Z0090,113570,110505,107737,19875,241,82.47,87862,81.55
2024-01-04,Z0063,128258,124012,118955,24438,286,85.45,94517,79.46
2024-01-04,Z0095,118865,115316,108233,11792,178,66.25,96441,89.1
2024-01-04,Z0027,128000,124839,119546,21950,190,115.53,97596,81.64
2024-01-04,Z0023,128565,126619,119693,10018,150,66.79,109675,91.63
2024-01-04,Z0022,102342,97400,90505,20839,298,69.93,69666,76.97
2024-01-04,Z0096,127641,125160,121259,16465,206,79.93,104794,86.42
2024-01-04,Z0036,106438,101891,98068,15022,204,73.64,83046,84.68
2024-01-04,Z0041,109846,105426,100347,24510,292,83.94,75837,75.57
2024-01-04,Z0081,100998,98140,93650,16182,202,80.11,77468,82.72
2024-01-04,Z0082,98519,94394,89084,12417,206,60.28,76667,86.06
2024-01-04,Z0079,93300,89674,83999,15435,184,83.89,68564,81.62
2024-01-04,Z0033,125822,123535,119392,19454,174,111.81,99938,83.71
2024-01-04,Z0020,111591,107442,104131,15105,187,80.78,89026,85.49
2024-01-04,Z0064,108922,103939,97392,20911,240,87.13,76481,78.53
2024-01-04,Z0099,111389,107607,104785,29493,257,114.76,75292,71.85
2024-01-04,Z0075,107327,104326,97901,15642,174,89.9,82259,84.02
2024-01-04,Z0042,106032,102834,97678,18649,237,78.69,79029,80.91
2024-01-04,Z0057,110079,105627,102713,16881,178,94.84,85832,83.56
2024-01-04,Z0055,103859,101551,95374,21889,299,73.21,73485,77.05
2024-01-04,Z0049,98705,95785,90191,26250,263,99.81,63941,70.9
2024-01-04,Z0072,127609,123539,120130,27061,230,117.66,93069,77.47
2024-01-05,Z0017,119378,117908,112718,25209,297,84.88,87509,77.64
2024-01-05,Z0050,104596,102792,95763,25399,212,119.81,70364,73.48
2024-01-05,Z0060,91279,88522,81522,15440,198,77.98,66082,81.06
2024-01-05,Z0076,97083,94193,86574,24313,290,83.84,62261,71.92
2024-01-05,Z0003,107771,105468,98780,29373,272,107.99,69407,70.26
2024-01-05,Z0109,109063,105957,99734,15257,211,72.31,84477,84.7
2024-01-05,Z0001,127599,123831,117878,17355,178,97.5,100523,85.28
2024-01-05,Z0011,125954,121674,117101,19724,179,110.19,97377,83.16
2024-01-05,Z0108,102808,99209,93176,10741,168,63.94,82435,88.47
2024-01-05,Z0043,124072,119642,111765,23344,227,102.84,88421,79.11
2024-01-05,Z0026,107685,103379,98838,22021,262,84.05,76817,77.72
2024-01-05,Z0093,101372,97715,91917,14030,212,66.18,77887,84.74
2024-01-05,Z0024,98996,97922,93747,17538,157,111.71,76209,81.29
2024-01-05,Z0019,116665,114286,112246,26507,252,105.19,85739,76.38
2024-01-05,Z0088,121653,118572,110776,12122,159,76.24,98654,89.06
2024-01-05,Z0077,121896,117851,110354,23721,259,91.59,86633,78.5
2024-01-05,Z0040,102875,100253,97912,28022,236,118.74,69890,71.38
2024-01-05,Z0107,105646,104001,97175,18635,181,102.96,78540,80.82
2024-01-05,Z0008,94263,92654,84786,20444,242,84.48,64342,75.89
2024-01-05,Z0009,98646,94693,90985,15103,206,73.32,75882,83.4
2024-01-05,Z0111,101664,97695,92667,14641,221,66.25,78026,84.2
2024-01-05,Z0103,114027,112326,107645,24462,216,113.25,83183,77.28
2024-01-05,Z0061,126397,123798,117573,17903,241,74.29,99670,84.77
2024-01-05,Z0028,125835,122990,119604,13724,184,74.59,105880,88.53
2024-01-05,Z0029,109250,107558,102195,21835,227,96.19,80360,78.63
2024-01-05,Z0037,111874,110081,103957,21412,195,109.81,82545,79.4
2024-01-05,Z0074,114063,110340,107204,22578,291,77.59,84626,78.94
2024-01-05,Z0051,114762,110908,107658,15286,156,97.99,92372,85.8
2024-01-05,Z0098,118769,117715,113004,14412,234,61.59,98592,87.25
2024-01-05,Z0073,94853,93448,86040,30849,274,112.59,55191,64.15
2024-01-05,Z0083,98942,94723,90961,15181,178,85.29,75780,83.31
2024-01-05,Z0053,121987,117425,111505,17310,151,114.64,94195,84.48
2024-01-05,Z0104,114058,112694,110213,23804,297,80.15,86409,78.4
2024-01-05,Z0045,122921,118400,114876,22816,279,81.78,92060,80.14
2024-01-05,Z0105,124888,121128,116785,20389,268,76.08,96396,82.54
2024-01-05,Z0089,127904,125240,122000,12429,154,80.71,109571,89.81
2024-01-05,Z0069,90060,88122,84483,24644,286,86.17,59839,70.83
2024-01-05,Z0002,103350,98476,92250,28993,248,116.91,63257,68.57
2024-01-05,Z0046,118145,115893,109690,25095,235,106.79,84595,77.12
2024-01-05,Z0034,99650,95101,88904,25785,230,112.11,63119,71.0
2024-01-05,Z0025,113393,109822,105500,32043,269,119.12,73457,69.63
2024-01-05,Z0100,116212,112097,106007,19647,277,70.93,86360,81.47
2024-01-05,Z0091,96960,92956,85820,16135,263,61.35,69685,81.2
2024-01-05,Z0006,126408,121514,113898,17033,163,104.5,96865,85.05
2024-01-05,Z0062,110491,108150,102487,13131,174,75.47,89356,87.19
2024-01-05,Z0092,114791,113453,105558,18827,171,110.1,86731,82.16
2024-01-05,Z0059,102254,98546,93394,10394,153,67.94,83000,88.87
2024-01-05,Z0110,91750,89242,84821,12513,178,70.3,72308,85.25
2024-01-05,Z0068,129887,128178,120859,11364,186,61.1,109495,90.6
2024-01-05,Z0101,105896,102383,95175,27075,295,91.78,68100,71.55
2024-01-05,Z0018,101918,97276,91283,18066,191,94.59,73217,80.21
2024-01-05,Z0070,115064,110116,102459,17064,183,93.25,85395,83.35
2024-01-05,Z0065,117935,116158,109023,27969,271,103.21,81054,74.35
2024-01-05,Z0058,94806,93406,87416,16135,266,60.66,71281,81.54
2024-01-05,Z0067,112297,108269,103112,20064,176,114.0,83048,80.54
2024-01-05,Z0048,118921,117531,111678,29412,283,103.93,82266,73.66
2024-01-05,Z0031,127198,125570,119338,23719,247,96.03,95619,80.12
2024-01-05,Z0086,101122,97387,93866,14245,202,70.52,79621,84.82
2024-01-05,Z0052,119398,116898,111604,25028,294,85.13,86576,77.57
2024-01-05,Z0030,115510,111468,104971,23121,271,85.32,81850,77.97
2024-01-05,Z0080,107850,103289,100675,19524,279,69.98,81151,80.61
2024-01-05,Z0084,111776,107179,103997,18191,256,71.06,85806,82.51
2024-01-05,Z0032,125435,122200,114983,19658,185,106.26,95325,82.9
2024-01-05,Z0078,106514,102662,95372,14838,178,83.36,80534,84.44
2024-01-05,Z0005,92983,88950,82672,16297,189,86.23,66375,80.29
2024-01-05,Z0007,113510,112147,110109,27061,262,103.29,83048,75.42
2024-01-05,Z0012,118535,114991,109404,17977,203,88.56,91427,83.57
2024-01-05,Z0021,105317,103397,98628,30485,260,117.25,68143,69.09
2024-01-05,Z0039,118687,117195,109650,31081,299,103.95,78569,71.65
2024-01-05,Z0054,99323,95382,89861,13866,182,76.19,75995,84.57
2024-01-05,Z0047,98502,96764,91523,20706,297,69.72,70817,77.38
2024-01-05,Z0016,90545,87084,80738,20649,230,89.78,60089,74.42
2024-01-05,Z0014,119430,116626,111414,17874,258,69.28,93540,83.96
2024-01-05,Z0004,119969,115482,107755,14321,222,64.51,93434,86.71
2024-01-05,Z0015,93810,90896,88083,14071,166,84.77,74012,84.03
2024-01-05,Z0106,106371,105343,98290,21273,210,101.3,77017,78.36
2024-01-05,Z0056,98436,96689,89897,16727,191,87.58,73170,81.39
2024-01-05,Z0102,123039,118528,114757,20083,184,109.15,94674,82.5
2024-01-05,Z0013,100616,99351,96431,26131,257,101.68,70300,72.9
2024-01-05,Z0010,114574,110144,103709,23947,251,95.41,79762,76.91
2024-01-05,Z0094,102676,99052,93292,13251,168,78.88,80041,85.8
2024-01-05,Z0044,92050,87550,84385,13505,198,68.21,70880,84.0
2024-01-05,Z0066,114951,110210,106177,22618,223,101.43,83559,78.7
2024-01-05,Z0097,122913,119932,113544,12779,196,65.2,100765,88.75
2024-01-05,Z0087,115280,111284,106652,25735,229,112.38,80917,75.87
2024-01-05,Z0071,94494,90630,87667,15439,157,98.34,72228,82.39
2024-01-05,Z0112,121883,118649,114608,22891,230,99.53,91717,80.03
2024-01-05,Z0038,91828,88720,82652,26227,267,98.23,56425,68.27
2024-01-05,Z0085,122123,120414,117608,19870,174,114.2,97738,83.1
2024-01-05,Z0035,119757,116889,110022,11796,161,73.27,98226,89.28
2024-01-05,Z0090,105934,103601,100717,25851,258,100.2,74866,74.33
2024-01-05,Z0063,126332,123943,118542,18521,181,102.33,100021,84.38
2024-01-05,Z0095,107320,103520,98967,20824,294,70.83,78143,78.96
2024-01-05,Z0027,104199,99354,95558,27008,235,114.93,68550,71.74
2024-01-05,Z0023,98245,94127,91401,10958,163,67.23,80443,88.01
2024-01-05,Z0022,101362,99319,95406,12143,156,77.84,83263,87.27
2024-01-05,Z0096,120448,117852,113938,26135,221,118.26,87803,77.06
2024-01-05,Z0036,97657,94191,89454,24185,231,104.7,65269,72.96
2024-01-05,Z0041,115425,112316,110314,29327,265,110.67,80987,73.41
2024-01-05,Z0081,118831,114021,107952,26948,295,91.35,81004,75.04
2024-01-05,Z0082,97287,95395,91365,15679,252,62.22,75686,82.84
2024-01-05,Z0079,127443,124510,121130,17278,257,67.23,103852,85.74
2024-01-05,Z0033,107674,105034,97987,27935,247,113.1,70052,71.49
2024-01-05,Z0020,113874,110192,107205,24247,257,94.35,82958,77.38
2024-01-05,Z0064,122284,117564,114346,24847,269,92.37,89499,78.27
2024-01-05,Z0099,127784,123999,120644,24127,242,99.7,96517,80.0
2024-01-05,Z0075,118841,117321,109739,28289,290,97.55,81450,74.22
2024-01-05,Z0042,105585,103602,100628,14125,165,85.61,86503,85.96
2024-01-05,Z0057,94133,90758,83388,19012,257,73.98,64376,77.2
2024-01-05,Z0055,93972,91773,84052,17894,204,87.72,66158,78.71
2024-01-05,Z0049,119125,118089,112702,11214,183,61.28,101488,90.05
2024-01-05,Z0072,99903,95883,93088,14861,162,91.74,78227,84.04
2024-01-06,Z0017,110420,108448,101760,26442,245,107.93,75318,74.02
2024-01-06,Z0050,128001,123890,120566,11387,188,60.57,109179,90.56
2024-01-06,Z0060,92396,89234,84489,18873,178,106.03,65616,77.66
2024-01-06,Z0076,91591,87480,79495,18734,211,88.79,60761,76.43
2024-01-06,Z0003,96183,91253,87257,18549,165,112.42,68708,78.74
2024-01-06,Z0109,124080,121795,115484,28647,270,106.1,86837,75.19
2024-01-06,Z0001,97314,93931,88692,23020,252,91.35,65672,74.05
2024-01-06,Z0011,92139,88739,85035,15906,214,74.33,69129,81.29
2024-01-06,Z0108,129692,128330,123726,13382,152,88.04,110344,89.18
2024-01-06,Z0043,122088,119372,112083,20774,269,77.23,91309,81.47
2024-01-06,Z0026,110670,105932,101463,22335,217,102.93,79128,77.99
2024-01-06,Z0093,112534,109354,106798,11630,186,62.53,95168,89.11
2024-01-06,Z0024,99017,95209,88059,14778,222,66.57,73281,83.22
2024-01-06,Z0019,102713,98248,93529,27210,270,100.78,66319,70.91
2024-01-06,Z0088,112890,108382,102641,33922,289,117.38,68719,66.95
2024-01-06,Z0077,126766,123637,119234,19935,186,107.18,99299,83.28
2024-01-06,Z0040,116588,114041,111747,23218,273,85.05,88529,79.22
2024-01-06,Z0107,100177,97930,90286,24736,212,116.68,65550,72.6
2024-01-06,Z0008,99882,97746,90394,18275,160,114.22,72119,79.78
2024-01-06,Z0009,124832,123473,116678,12843,201,63.9,103835,88.99
2024-01-06,Z0111,127311,123408,116638,25759,221,116.56,90879,77.92
2024-01-06,Z0103,91007,88658,84144,15651,212,73.83,68493,81.4
2024-01-06,Z0061,119257,117001,113754,19124,259,73.84,94630,83.19
2024-01-06,Z0028,103281,98379,94944,15085,206,73.23,79859,84.11
2024-01-06,Z0029,123339,119957,116712,16654,152,109.57,100058,85.73
2024-01-06,Z0037,116660,114672,112395,9774,154,63.47,102621,91.3
2024-01-06,Z0074,103507,99544,95657,14304,196,72.98,81353,85.05
2024-01-06,Z0051,97491,95761,92721,18275,158,115.67,74446,80.29
2024-01-06,Z0098,104859,102942,100057,24796,271,91.5,75261,75.22
2024-01-06,Z0073,110953,106762,102409,22785,272,83.77,79624,77.75
2024-01-06,Z0083,113821,112118,109432,23506,231,101.76,85926,78.52
2024-01-06,Z0053,114860,113145,107398,16560,152,108.95,90838,84.58
2024-01-06,Z0104,115338,113088,106045,11895,162,73.43,94150,88.78
2024-01-06,Z0045,125196,121689,114563,22748,238,95.58,91815,80.14
2024-01-06,Z0105,97813,93887,87888,32478,291,111.61,55410,63.05
2024-01-06,Z0089,117570,114064,107399,18024,160,112.65,89375,83.22
2024-01-06,Z0069,120678,116069,110516,16498,216,76.38,94018,85.07
2024-01-06,Z0002,116029,114292,108936,20170,178,113.32,88766,81.48
2024-01-06,Z0046,104288,100118,98080,13979,225,62.13,84101,85.75
2024-01-06,Z0034,93342,91456,86612,21905,189,115.9,64707,74.71
2024-01-06,Z0025,100396,98298,94475,18783,288,65.22,75692,80.12
2024-01-06,Z0100,103261,99106,94013,22484,273,82.36,71529,76.08
2024-01-06,Z0091,101722,99160,93382,22484,221,101.74,70898,75.92
2024-01-06,Z0006,118087,113412,110424,21978,239,91.96,88446,80.1
2024-01-06,Z0062,129214,127346,121320,13617,186,73.21,107703,88.78
2024-01-06,Z0092,124450,121474,113968,11428,177,64.57,102540,89.97
2024-01-06,Z0059,95626,91298,84633,14648,230,63.69,69985,82.69
2024-01-06,Z0110,109982,105749,101769,17234,194,88.84,84535,83.07
2024-01-06,Z0068,116431,112375,109583,27682,242,114.39,81901,74.74
2024-01-06,Z0101,107175,102580,98771,17467,216,80.87,81304,82.32
2024-01-06,Z0018,128158,124619,120364,22879,247,92.63,97485,80.99
2024-01-06,Z0070,109994,107387,100208,20515,182,112.72,79693,79.53
2024-01-06,Z0065,129341,127357,119581,33178,296,112.09,86403,72.25
2024-01-06,Z0058,126444,122064,119545,26758,241,111.03,92787,77.62
2024-01-06,Z0067,98782,96732,88927,14480,208,69.62,74447,83.72
2024-01-06,Z0048,110017,106982,100538,17855,162,110.22,82683,82.24
2024-01-06,Z0031,107343,104380,101688,27562,238,115.81,74126,72.9
2024-01-06,Z0086,95655,90756,84283,24182,249,97.12,60101,71.31
2024-01-06,Z0052,105251,100622,98096,17612,156,112.9,80484,82.05
2024-01-06,Z0030,93224,89443,85190,21788,194,112.31,63402,74.42
2024-01-06,Z0080,101536,96571,89216,19719,180,109.55,69497,77.9
2024-01-06,Z0084,124531,123011,115214,31340,287,109.2,83874,72.8
2024-01-06,Z0032,99208,95205,88096,13094,188,69.65,75002,85.14
2024-01-06,Z0078,125201,122834,120251,23249,249,93.37,97002,80.67
2024-01-06,Z0005,119759,114971,110203,20441,226,90.45,89762,81.45
2024-01-06,Z0007,126935,122075,119802,13458,188,71.59,106344,88.77
2024-01-06,Z0012,116589,114246,107813,15717,162,97.02,92096,85.42
2024-01-06,Z0021,107773,103207,96505,24520,262,93.59,71985,74.59
2024-01-06,Z0039,116143,113085,105665,19124,253,75.59,86541,81.9
2024-01-06,Z0054,110581,106085,98574,25861,237,109.12,72713,73.76
2024-01-06,Z0047,122981,118219,111012,16863,219,77.0,94149,84.81
2024-01-06,Z0016,99768,96320,91384,19162,223,85.93,72222,79.03
2024-01-06,Z0014,128559,124025,121434,17708,212,83.53,103726,85.42
2024-01-06,Z0004,119781,116642,111922,26429,228,115.92,85493,76.39
2024-01-06,Z0015,98905,96970,90633,19875,171,116.23,70758,78.07
2024-01-06,Z0106,96368,92520,84656,26031,245,106.25,58625,69.25
2024-01-06,Z0056,108333,104697,101780,16939,217,78.06,84841,83.36
2024-01-06,Z0102,105525,101607,99518,17639,166,106.26,81879,82.28
2024-01-06,Z0013,100361,99219,94178,27909,294,94.93,66269,70.37
2024-01-06,Z0010,90105,88219,85792,16629,171,97.25,69163,80.62
2024-01-06,Z0094,96090,94774,92140,23762,199,119.41,68378,74.21
2024-01-06,Z0044,91925,88869,83725,15443,178,86.76,68282,81.56
2024-01-06,Z0066,116015,114463,111748,22747,274,83.02,89001,79.64
2024-01-06,Z0097,126679,123966,115987,10916,178,61.33,105071,90.59
2024-01-06,Z0087,93389,91282,83845,23293,283,82.31,60552,72.22
2024-01-06,Z0071,114826,111396,107342,12432,207,60.06,94910,88.42
2024-01-06,Z0112,123226,121119,118912,20765,178,116.66,98147,82.54
2024-01-06,Z0038,90899,86438,81053,21595,248,87.08,59458,73.36
2024-01-06,Z0085,106405,104996,102102,17224,188,91.62,84878,83.13
2024-01-06,Z0035,123282,119084,112180,18088,178,101.62,94092,83.88
2024-01-06,Z0090,119545,118532,111466,29256,265,110.4,82210,73.75
2024-01-06,Z0063,105313,101252,97118,23129,233,99.27,73989,76.18
2024-01-06,Z0095,91560,89236,85970,19726,176,112.08,66244,77.05
2024-01-06,Z0027,116745,112527,106889,18991,275,69.06,87898,82.23
2024-01-06,Z0023,94780,91853,86049,25035,241,103.88,61014,70.91
2024-01-06,Z0022,92356,90662,86327,16695,196,85.18,69632,80.66
2024-01-06,Z0096,114363,109698,105709,19539,233,83.86,86170,81.52
2024-01-06,Z0036,129825,125031,122370,22041,280,78.72,100329,81.99
2024-01-06,Z0041,127412,122989,120678,23525,207,113.65,97153,80.51
2024-01-06,Z0081,92920,90838,85867,17179,164,104.75,68688,79.99
2024-01-06,Z0082,104025,102271,96141,23875,213,112.09,72266,75.17
2024-01-06,Z0079,129004,126022,118696,14205,173,82.11,104491,88.03
2024-01-06,Z0033,123120,121218,113767,14479,164,88.29,99288,87.27
2024-01-06,Z0020,97005,94257,92099,20783,176,118.09,71316,77.43
2024-01-06,Z0064,90956,87885,85482,19248,294,65.47,66234,77.48
2024-01-06,Z0099,102803,99024,95637,16682,157,106.26,78955,82.56
2024-01-06,Z0075,126221,122642,119687,21026,199,105.66,98661,82.43
2024-01-06,Z0042,129063,124430,120718,30186,280,107.81,90532,74.99
2024-01-06,Z0057,105282,103675,100402,19938,173,115.25,80464,80.14
2024-01-06,Z0055,121860,117947,110316,19916,280,71.13,90400,81.95
2024-01-06,Z0049,102003,98378,93996,14577,164,88.89,79419,84.49
2024-01-06,Z0072,116017,112038,108241,16009,166,96.44,92232,85.21
2024-01-07,Z0017,102201,100447,97053,19996,233,85.82,77057,79.4
2024-01-07,Z0050,111116,108825,103111,21007,212,99.09,82104,79.63
2024-01-07,Z0060,123297,118674,113716,25381,266,95.42,88335,77.68
2024-01-07,Z0076,117490,115697,110106,17375,221,78.62,92731,84.22
2024-01-07,Z0003,116723,112924,106351,19421,221,87.88,86930,81.74
2024-01-07,Z0109,101561,99622,97097,17834,213,83.73,79263,81.63
2024-01-07,Z0001,112861,111860,109486,25207,244,103.31,84279,76.98
2024-01-07,Z0011,116916,113032,107027,16272,160,101.7,90755,84.8
2024-01-07,Z0108,94648,91283,87758,21323,182,117.16,66435,75.7
2024-01-07,Z0043,120523,119143,115497,29486,285,103.46,86011,74.47
2024-01-07,Z0026,122781,121278,117000,16296,237,68.76,100704,86.07
2024-01-07,Z0093,125923,124794,118980,26820,225,119.2,92160,77.46
2024-01-07,Z0024,125984,122046,116118,20367,229,88.94,95751,82.46
2024-01-07,Z0019,116616,115589,111476,24618,241,102.15,86858,77.92
2024-01-07,Z0088,103760,101313,94758,22400,246,91.06,72358,76.36
2024-01-07,Z0077,122419,121119,115745,20556,182,112.95,95189,82.24
2024-01-07,Z0040,129198,124732,119651,14624,226,64.71,105027,87.78
2024-01-07,Z0107,123397,122128,117489,23719,299,79.33,93770,79.81
2024-01-07,Z0008,95724,92923,88032,18156,252,72.05,69876,79.38
2024-01-07,Z0009,109816,107536,99641,29278,271,108.04,70363,70.62
2024-01-07,Z0111,103994,99975,95615,17862,255,70.05,77753,81.32
2024-01-07,Z0103,106959,103026,99719,23183,198,117.09,76536,76.75
2024-01-07,Z0061,109576,105398,100664,21501,210,102.39,79163,78.64
2024-01-07,Z0028,96116,91841,87629,27080,283,95.69,60549,69.1
2024-01-07,Z0029,116928,112360,108705,14012,222,63.12,94693,87.11
2024-01-07,Z0037,116155,113308,109105,19482,190,102.54,89623,82.14
2024-01-07,Z0074,107774,105032,101107,18343,157,116.84,82764,81.86
2024-01-07,Z0051,90619,88345,85389,26052,241,108.1,59337,69.49
2024-01-07,Z0098,124707,119754,115373,20412,211,96.74,94961,82.31
2024-01-07,Z0073,106001,104033,100717,17887,276,64.81,82830,82.24
2024-01-07,Z0083,115619,114338,109494,21710,233,93.18,87784,80.17
2024-01-07,Z0053,105360,102194,99136,30858,283,109.04,68278,68.87
2024-01-07,Z0104,110677,107145,101317,27216,276,98.61,74101,73.14
2024-01-07,Z0045,127946,124062,116782,13269,190,69.84,103513,88.64
2024-01-07,Z0105,99200,95462,92233,10578,163,64.9,81655,88.53
2024-01-07,Z0089,115611,114122,111847,12047,161,74.83,99800,89.23
2024-01-07,Z0069,125057,122818,115448,25740,290,88.76,89708,77.7
2024-01-07,Z0002,90125,88909,83041,21609,271,79.74,61432,73.98
2024-01-07,Z0046,105398,103152,97903,26060,249,104.66,71843,73.38
2024-01-07,Z0034,99110,94611,87198,23053,268,86.02,64145,73.56
2024-01-07,Z0025,102115,98917,91160,16270,181,89.89,74890,82.15
2024-01-07,Z0100,122556,121249,113794,14148,231,61.25,99646,87.57
2024-01-07,Z0091,91969,88176,85285,23902,299,79.94,61383,71.97
2024-01-07,Z0006,94470,90391,86358,24290,205,118.49,62068,71.87
2024-01-07,Z0062,113196,108773,101296,18169,280,64.89,83127,82.06
2024-01-07,Z0092,127380,124862,118681,13474,184,73.23,105207,88.65
2024-01-07,Z0059,128006,123717,119243,27165,246,110.43,92078,77.22
2024-01-07,Z0110,112473,107988,101939,22195,198,112.1,79744,78.23
2024-01-07,Z0068,105504,100895,95176,14796,173,85.53,80380,84.45
2024-01-07,Z0101,90302,86511,80559,15930,153,104.12,64629,80.23
2024-01-07,Z0018,119259,117273,113410,32796,275,119.26,80614,71.08
2024-01-07,Z0070,127208,125395,120323,22291,199,112.02,98032,81.47
2024-01-07,Z0065,121890,119580,111807,23343,245,95.28,88464,79.12
2024-01-07,Z0058,109508,107181,99993,22272,266,83.73,77721,77.73
2024-01-07,Z0067,116984,112311,107020,20609,215,95.86,86411,80.74
2024-01-07,Z0048,94033,92024,89321,15391,155,99.3,73930,82.77
2024-01-07,Z0031,95704,91472,84264,20335,264,77.03,63929,75.87
2024-01-07,Z0086,96924,93292,87464,19903,274,72.64,67561,77.24
2024-01-07,Z0052,109614,108126,104779,16347,167,97.89,88432,84.4
2024-01-07,Z0030,125941,124448,120781,21651,292,74.15,99130,82.07
2024-01-07,Z0080,116213,115195,109642,18016,175,102.95,91626,83.57
2024-01-07,Z0084,97761,94317,91317,23116,236,97.95,68201,74.69
2024-01-07,Z0032,115426,113038,105588,19279,163,118.28,86309,81.74
2024-01-07,Z0078,93712,91345,88524,22721,268,84.78,65803,74.33
2024-01-07,Z0005,116200,112428,106702,14217,190,74.83,92485,86.68
2024-01-07,Z0007,113616,109469,103380,17618,209,84.3,85762,82.96
2024-01-07,Z0012,127574,124384,121468,14815,163,90.89,106653,87.8
2024-01-07,Z0021,102178,98303,90711,22270,233,95.58,68441,75.45
2024-01-07,Z0039,107824,106520,103785,21709,219,99.13,82076,79.08
2024-01-07,Z0054,118144,114806,109468,28122,238,118.16,81346,74.31
2024-01-07,Z0047,129778,125763,120874,23968,215,111.48,96906,80.17
2024-01-07,Z0016,115537,111548,105700,12244,154,79.51,93456,88.42
2024-01-07,Z0014,112612,107747,102884,14398,194,74.22,88486,86.01
2024-01-07,Z0004,116523,112847,109670,13348,180,74.16,96322,87.83
2024-01-07,Z0015,94760,93749,86497,18740,267,70.19,67757,78.33
2024-01-07,Z0106,106353,105050,99686,19413,242,80.22,80273,80.53
2024-01-07,Z0056,117598,113227,105368,16706,243,68.75,88662,84.15
2024-01-07,Z0102,98234,96291,91901,21127,282,74.92,70774,77.01
2024-01-07,Z0013,106173,102628,98217,11272,150,75.15,86945,88.52
2024-01-07,Z0010,103178,99704,96700,18706,267,70.06,77994,80.66
2024-01-07,Z0094,114596,113190,110176,26009,270,96.33,84167,76.39
2024-01-07,Z0044,94431,91593,86405,21908,198,110.65,64497,74.64
2024-01-07,Z0066,111627,108181,100258,16748,193,86.78,83510,83.3
2024-01-07,Z0097,98906,97856,92002,29146,260,112.1,62856,68.32
2024-01-07,Z0087,103076,101936,95371,23744,257,92.39,71627,75.1
2024-01-07,Z0071,127650,124825,117372,22625,297,76.18,94747,80.72
2024-01-07,Z0112,96012,94049,91677,18799,279,67.38,72878,79.49
2024-01-07,Z0038,118211,114670,109060,21613,186,116.2,87447,80.18
2024-01-07,Z0085,96894,94715,86948,17515,178,98.4,69433,79.86
2024-01-07,Z0035,102289,98653,94516,16031,184,87.13,78485,83.04
2024-01-07,Z0090,110829,106299,103013,16425,208,78.97,86588,84.06
2024-01-07,Z0063,119734,115778,110124,11092,161,68.9,99032,89.93
2024-01-07,Z0095,113486,110127,107683,11719,192,61.04,95964,89.12
2024-01-07,Z0027,96441,94490,92455,23559,199,118.39,68896,74.52
2024-01-07,Z0023,102149,99351,95506,16408,188,87.28,79098,82.82
2024-01-07,Z0022,111675,109276,105568,12787,187,68.38,92781,87.89
2024-01-07,Z0096,103673,100067,95129,18824,277,67.96,76305,80.21
2024-01-07,Z0036,112668,108734,105434,20558,201,102.28,84876,80.5
2024-01-07,Z0041,113253,111010,105034,27411,273,100.41,77623,73.9
2024-01-07,Z0081,127384,124578,122569,15357,234,65.63,107212,87.47
2024-01-07,Z0082,100617,97961,94301,10891,157,69.37,83410,88.45
2024-01-07,Z0079,121401,117770,110955,28134,251,112.09,82821,74.64
2024-01-07,Z0033,125993,124135,120819,17700,235,75.32,103119,85.35
2024-01-07,Z0020,129575,125997,120314,24218,204,118.72,96096,79.87
2024-01-07,Z0064,97227,92989,87716,19632,263,74.65,68084,77.62
2024-01-07,Z0099,113384,112239,105229,19622,175,112.13,85607,81.35
2024-01-07,Z0075,106035,101995,98533,16196,262,61.82,82337,83.56
2024-01-07,Z0042,116160,114678,109499,23808,221,107.73,85691,78.26
2024-01-07,Z0057,107633,105961,103331,17479,182,96.04,85852,83.08
2024-01-07,Z0055,104996,103335,97832,17915,180,99.53,79917,81.69
2024-01-07,Z0049,92852,88126,83660,20204,202,100.02,63456,75.85
2024-01-07,Z0072,123755,119229,115683,16865,254,66.4,98818,85.42
2024-01-08,Z0017,99160,95523,92423,25149,212,118.63,67274,72.79
2024-01-08,Z0050,129420,127980,120964,26715,238,112.25,94249,77.91
2024-01-08,Z0060,123537,121194,113272,14525,222,65.43,98747,87.18
2024-01-08,Z0076,94358,89690,83961,21489,217,99.03,62472,74.41
2024-01-08,Z0003,118482,115905,109897,19984,251,79.62,89913,81.82
2024-01-08,Z0109,122496,118990,111896,21658,251,86.29,90238,80.64
2024-01-08,Z0001,119371,116022,110420,26026,231,112.67,84394,76.43
2024-01-08,Z0011,128467,126226,123101,14814,172,86.13,108287,87.97
2024-01-08,Z0108,100793,97458,94268,18488,224,82.54,75780,80.39
2024-01-08,Z0043,129532,127527,121396,20084,203,98.94,101312,83.46
2024-01-08,Z0026,97843,94921,92849,28560,292,97.81,64289,69.24
2024-01-08,Z0093,121367,118991,115077,29705,292,101.73,85372,74.19
2024-01-08,Z0024,127957,124485,119439,19418,209,92.91,100021,83.74
2024-01-08,Z0019,96704,92829,87116,18362,198,92.74,68754,78.92
2024-01-08,Z0088,95051,91487,87012,13549,184,73.64,73463,84.43
2024-01-08,Z0077,126378,125219,120396,15393,160,96.21,105003,87.21
2024-01-08,Z0040,124503,121918,119852,25524,259,98.55,94328,78.7
2024-01-08,Z0107,125196,124139,121798,13080,158,82.79,108718,89.26
2024-01-08,Z0008,122581,120428,115654,20490,175,117.09,95164,82.28
2024-01-08,Z0009,109201,105540,102308,28948,266,108.83,73360,71.71
2024-01-08,Z0111,99686,96865,90654,11099,161,68.94,79555,87.76
2024-01-08,Z0103,122007,120346,114463,18677,197,94.81,95786,83.68
2024-01-08,Z0061,120137,115518,111650,17099,193,88.6,94551,84.69
2024-01-08,Z0028,100526,96152,93136,20330,192,105.89,72806,78.17
2024-01-08,Z0029,118982,117775,113110,22953,219,104.81,90157,79.71
2024-01-08,Z0037,113197,111565,107463,30153,257,117.33,77310,71.94
2024-01-08,Z0074,93083,91427,83908,12197,170,71.75,71711,85.46
2024-01-08,Z0051,110103,106076,101514,22636,229,98.85,78878,77.7
2024-01-08,Z0098,124447,119834,117598,32017,273,117.28,85581,72.77
2024-01-08,Z0073,97446,96099,89374,21389,185,115.62,67985,76.07
2024-01-08,Z0083,116116,113113,107170,11780,164,71.83,95390,89.01
2024-01-08,Z0053,108752,104048,101763,23519,290,81.1,78244,76.89
2024-01-08,Z0104,122916,120809,114772,12806,183,69.98,101966,88.84
2024-01-08,Z0045,116342,114543,107263,20505,266,77.09,86758,80.88
2024-01-08,Z0105,101023,97516,93993,20377,176,115.78,73616,78.32
2024-01-08,Z0089,109169,105613,99888,17454,184,94.86,82434,82.53
2024-01-08,Z0069,106163,104683,96901,24638,255,96.62,72263,74.57
2024-01-08,Z0002,112641,108845,105244,24777,295,83.99,80467,76.46
2024-01-08,Z0046,108792,107452,102635,19167,226,84.81,83468,81.33
2024-01-08,Z0034,120682,116874,112378,21741,238,91.35,90637,80.65
2024-01-08,Z0025,128067,125342,121653,15735,156,100.87,105918,87.07
2024-01-08,Z0100,126035,121498,115092,24081,223,107.99,91011,79.08
2024-01-08,Z0091,114837,112395,109990,17098,220,77.72,92892,84.45
2024-01-08,Z0006,100382,99041,91606,21978,191,115.07,69628,76.01
2024-01-08,Z0062,114819,113330,107223,20739,233,89.01,86484,80.66
2024-01-08,Z0092,121982,120422,114285,16994,156,108.94,97291,85.13
2024-01-08,Z0059,115169,112717,108891,24637,269,91.59,84254,77.37
2024-01-08,Z0110,101421,97134,91061,22947,196,117.08,68114,74.8
2024-01-08,Z0068,97629,96496,91358,26339,268,98.28,65019,71.17
2024-01-08,Z0101,118495,114417,107374,19218,170,113.05,88156,82.1
2024-01-08,Z0018,98264,96866,89342,30779,286,107.62,58563,65.55
2024-01-08,Z0070,114226,110601,104376,15852,164,96.66,88524,84.81
2024-01-08,Z0065,97373,94562,88201,22127,271,81.65,66074,74.91
2024-01-08,Z0058,95656,92671,89879,23470,221,106.2,66409,73.89
2024-01-08,Z0067,119984,118821,116727,14693,198,74.21,102034,87.41
2024-01-08,Z0048,95901,92021,88888,14530,186,78.12,74358,83.65
2024-01-08,Z0031,121055,119234,116997,18659,168,111.07,98338,84.05
2024-01-08,Z0086,104716,100209,95263,15643,238,65.73,79620,83.58
2024-01-08,Z0052,125298,122338,119290,15277,218,70.08,104013,87.19
2024-01-08,Z0030,95772,91584,87055,28724,257,111.77,58331,67.0
2024-01-08,Z0080,125732,121691,118728,24688,268,92.12,94040,79.21
2024-01-08,Z0084,106920,102770,95071,18364,299,61.42,76707,80.68
2024-01-08,Z0032,113563,108692,102469,21552,292,73.81,80917,78.97
2024-01-08,Z0078,101871,100780,95056,11827,160,73.92,83229,87.56
2024-01-08,Z0005,98734,96889,91286,22227,227,97.92,69059,75.65
2024-01-08,Z0007,125262,123873,119154,11546,151,76.47,107608,90.31
2024-01-08,Z0012,108268,107226,100877,15866,156,101.71,85011,84.27
2024-01-08,Z0021,127947,124237,116601,18696,216,86.56,97905,83.97
2024-01-08,Z0039,121497,118105,111368,28238,274,103.06,83130,74.64
2024-01-08,Z0054,126618,124929,117557,11712,173,67.7,105845,90.04
2024-01-08,Z0047,116526,114447,106865,16159,168,96.19,90706,84.88
2024-01-08,Z0016,115032,113050,108920,23769,251,94.7,85151,78.18
2024-01-08,Z0014,119794,118646,111198,16710,258,64.77,94488,84.97
2024-01-08,Z0004,118861,114296,111414,23554,246,95.75,87860,78.86
2024-01-08,Z0015,96406,92255,89856,17626,222,79.4,72230,80.38
2024-01-08,Z0106,113291,111683,103792,21925,272,80.61,81867,78.88
2024-01-08,Z0056,124406,121831,117683,14764,162,91.14,102919,87.45
2024-01-08,Z0102,91382,88979,86160,27950,279,100.18,58210,67.56
2024-01-08,Z0013,93292,91473,89054,17320,176,98.41,71734,80.55
2024-01-08,Z0010,102411,100990,95688,17709,157,112.8,77979,81.49
2024-01-08,Z0094,105422,102914,95221,20061,199,100.81,75160,78.93
2024-01-08,Z0044,123535,120491,116352,15335,193,79.46,101017,86.82
2024-01-08,Z0066,117605,115056,111292,10855,152,71.42,100437,90.25
2024-01-08,Z0097,128908,125263,119547,33382,279,119.65,86165,72.08
2024-01-08,Z0087,94481,91884,87591,12348,151,81.78,75243,85.9
2024-01-08,Z0071,127605,122943,118235,19106,184,103.84,99129,83.84
2024-01-08,Z0112,113177,108635,101093,14321,179,80.01,86772,85.83
2024-01-08,Z0038,115476,112364,107280,28028,299,93.74,79252,73.87
2024-01-08,Z0085,112740,109731,107490,21774,185,117.7,85716,79.74
2024-01-08,Z0035,106052,102667,96399,18952,180,105.29,77447,80.34
2024-01-08,Z0090,90671,89508,87044,18798,204,92.15,68246,78.4
2024-01-08,Z0063,94795,91353,84555,29513,270,109.31,55042,65.1
2024-01-08,Z0095,112420,109065,101178,13016,161,80.85,88162,87.14
2024-01-08,Z0027,119300,114435,109878,34353,289,118.87,75525,68.74
2024-01-08,Z0023,128595,127050,119367,17575,152,115.63,101792,85.28
2024-01-08,Z0022,127487,122652,120059,14441,172,83.96,105618,87.97
2024-01-08,Z0096,111223,106925,99061,15483,253,61.2,83578,84.37
2024-01-08,Z0036,118380,115921,110428,26848,253,106.12,83580,75.69
2024-01-08,Z0041,120911,119895,114704,23651,214,110.52,91053,79.38
2024-01-08,Z0081,123160,121736,119165,19542,298,65.58,99623,83.6
2024-01-08,Z0082,93631,90555,87435,19539,299,65.35,67896,77.65
2024-01-08,Z0079,113561,112320,106423,12246,181,67.66,94177,88.49
2024-01-08,Z0033,118671,115392,112604,14917,165,90.41,97687,86.75
2024-01-08,Z0020,117425,115650,109624,19514,291,67.06,90110,82.2
2024-01-08,Z0064,113253,110006,107928,21171,263,80.5,86757,80.38
2024-01-08,Z0099,98080,94077,88151,16576,254,65.26,71575,81.2
2024-01-08,Z0075,115431,111187,103652,24532,224,109.52,79120,76.33
2024-01-08,Z0042,129851,126355,122207,14220,204,69.71,107987,88.36
2024-01-08,Z0057,94940,90669,85093,26856,299,89.82,58237,68.44
2024-01-08,Z0055,118758,115668,110212,22087,235,93.99,88125,79.96
2024-01-08,Z0049,97788,93282,90875,18650,161,115.84,72225,79.48
2024-01-08,Z0072,114034,110323,105235,17644,191,92.38,87591,83.23
2024-01-09,Z0017,108052,106905,100578,18484,184,100.46,82094,81.62
2024-01-09,Z0050,100142,98777,95103,19379,283,68.48,75724,79.62
2024-01-09,Z0060,94531,93133,85803,12211,156,78.28,73592,85.77
2024-01-09,Z0076,128278,124732,122170,17615,222,79.35,104555,85.58
2024-01-09,Z0003,118138,114649,107269,14884,215,69.23,92385,86.12
2024-01-09,Z0109,129261,126224,120801,15950,169,94.38,104851,86.8
2024-01-09,Z0001,100759,98416,94843,17386,159,109.35,77457,81.67
2024-01-09,Z0011,118270,116279,110988,15444,174,88.76,95544,86.08
2024-01-09,Z0108,113888,111642,105923,20997,182,115.37,84926,80.18
2024-01-09,Z0043,125144,121135,116142,11141,163,68.35,105001,90.41
2024-01-09,Z0026,115538,110906,107079,24248,229,105.89,82831,77.36
2024-01-09,Z0093,122125,118242,114629,21659,274,79.05,92970,81.11
2024-01-09,Z0024,102504,101127,94913,19464,283,68.78,75449,79.49
2024-01-09,Z0019,110669,106855,104486,17904,266,67.31,86582,82.86
2024-01-09,Z0088,124964,120217,117566,18341,298,61.55,99225,84.4
2024-01-09,Z0077,95978,93467,90698,12867,174,73.95,77831,85.81
2024-01-09,Z0040,123548,120832,114849,18989,161,117.95,95860,83.47
2024-01-09,Z0107,99503,95144,87799,23436,245,95.66,64363,73.31
2024-01-09,Z0008,106905,105123,100803,16266,180,90.37,84537,83.86
2024-01-09,Z0009,113953,110723,104683,22617,295,76.67,82066,78.39
2024-01-09,Z0111,112168,110681,102735,16985,283,60.02,85750,83.47
2024-01-09,Z0103,129896,125199,120362,18658,192,97.18,101704,84.5
2024-01-09,Z0061,102275,98814,90970,17115,209,81.89,73855,81.19
2024-01-09,Z0028,101435,97076,94391,11462,180,63.68,82929,87.86
2024-01-09,Z0029,108544,104609,98621,11560,159,72.71,87061,88.28
2024-01-09,Z0037,102258,99089,95522,32914,275,119.69,62608,65.54
2024-01-09,Z0074,100736,98957,95701,15957,205,77.84,79744,83.33
2024-01-09,Z0051,124964,120496,115788,16295,232,70.24,99493,85.93
2024-01-09,Z0098,105997,103070,100769,20049,298,67.28,80720,80.1
2024-01-09,Z0073,113911,110626,107980,18656,264,70.67,89324,82.72
2024-01-09,Z0083,119334,116051,112292,18675,293,63.74,93617,83.37
2024-01-09,Z0053,118927,117330,114669,14992,153,97.99,99677,86.93
2024-01-09,Z0104,110714,108346,103765,20570,189,108.84,83195,80.18
2024-01-09,Z0045,113387,108519,102982,18459,252,73.25,84523,82.08
2024-01-09,Z0105,103057,99469,93161,19967,201,99.34,73194,78.57
2024-01-09,Z0089,114858,110225,104547,22796,212,107.53,81751,78.2
2024-01-09,Z0069,116062,113632,107449,20939,211,99.24,86510,80.51
2024-01-09,Z0002,119739,118279,113954,14278,156,91.53,99676,87.47
2024-01-09,Z0046,93754,90286,86562,11509,163,70.61,75053,86.7
2024-01-09,Z0034,91376,87633,85119,27690,235,117.83,57429,67.47
2024-01-09,Z0025,98894,96241,92175,18980,279,68.03,73195,79.41
2024-01-09,Z0100,106406,102946,95797,18222,298,61.15,77575,80.98
2024-01-09,Z0091,95926,92771,89467,21644,228,94.93,67823,75.81
2024-01-09,Z0006,126068,123934,121573,14775,207,71.38,106798,87.85
2024-01-09,Z0062,126495,121840,113845,20560,282,72.91,93285,81.94
2024-01-09,Z0092,115860,114346,111898,14756,231,63.88,97142,86.81
2024-01-09,Z0059,128787,124612,117010,25130,288,87.26,91880,78.52
2024-01-09,Z0110,111727,108872,101903,15267,201,75.96,86636,85.02
2024-01-09,Z0068,92520,88439,85011,23751,266,89.29,61260,72.06
2024-01-09,Z0101,126735,123386,115536,14544,183,79.48,100992,87.41
2024-01-09,Z0018,115498,111361,107202,20457,231,88.56,86745,80.92
2024-01-09,Z0070,127900,125484,120937,20456,191,107.1,100481,83.09
2024-01-09,Z0065,109363,105718,101437,19717,290,67.99,81720,80.56
2024-01-09,Z0058,109033,107720,103107,16520,166,99.52,86587,83.98
2024-01-09,Z0067,125851,122595,119558,30171,278,108.53,89387,74.76
2024-01-09,Z0048,103944,99455,94821,14830,197,75.28,79991,84.36
2024-01-09,Z0031,126751,123973,116863,18415,159,115.82,98448,84.24
2024-01-09,Z0086,102087,97805,94681,18616,170,109.51,76065,80.34
2024-01-09,Z0052,107081,103902,100498,15221,183,83.18,85277,84.85
2024-01-09,Z0030,128019,125976,122047,25846,228,113.36,96201,78.82
2024-01-09,Z0080,91013,89787,85959,21499,236,91.1,64460,74.99
2024-01-09,Z0084,97909,95417,88500,22726,218,104.25,65774,74.32
2024-01-09,Z0032,92023,90153,85701,23791,236,100.81,61910,72.24
2024-01-09,Z0078,104537,101452,93561,14075,226,62.28,79486,84.96
2024-01-09,Z0005,123848,121908,117588,24303,236,102.98,93285,79.33
2024-01-09,Z0007,117766,114136,109573,27897,258,108.13,81676,74.54
2024-01-09,Z0012,126060,124535,118949,19486,166,117.39,99463,83.62
2024-01-09,Z0021,106087,101275,94844,14154,170,83.26,80690,85.08
2024-01-09,Z0039,113225,111147,106200,30950,259,119.5,75250,70.86
2024-01-09,Z0054,126727,122914,118331,34029,292,116.54,84302,71.24
2024-01-09,Z0047,90161,85420,82827,14388,177,81.29,68439,82.63
2024-01-09,Z0016,104226,101020,95761,14318,154,92.98,81443,85.05
2024-01-09,Z0014,118731,114769,108881,15709,245,64.12,93172,85.57
2024-01-09,Z0004,93390,90489,83988,17581,287,61.26,66407,79.07
2024-01-09,Z0015,90541,88204,81111,30816,261,118.07,50295,62.01
2024-01-09,Z0106,103428,99454,96587,30252,285,106.15,66335,68.68
2024-01-09,Z0056,100258,98827,91992,18408,222,82.92,73584,79.99
2024-01-09,Z0102,95469,94287,91081,14913,198,75.32,76168,83.63
2024-01-09,Z0013,100720,98551,95721,23106,217,106.48,72615,75.86
2024-01-09,Z0010,91651,89515,84705,24037,271,88.7,60668,71.62
2024-01-09,Z0094,115051,111241,107915,20863,263,79.33,87052,80.67
2024-01-09,Z0044,106184,104165,96928,25564,289,88.46,71364,73.63
2024-01-09,Z0066,100028,98868,94420,14512,151,96.11,79908,84.63
2024-01-09,Z0097,124051,122392,114521,22265,244,91.25,92256,80.56
2024-01-09,Z0087,108394,106996,103263,17989,181,99.39,85274,82.58
2024-01-09,Z0071,120254,117129,112958,10019,160,62.62,102939,91.13
2024-01-09,Z0112,104472,102871,97400,19204,166,115.69,78196,80.28
2024-01-09,Z0038,120268,119131,115034,19346,208,93.01,95688,83.18
2024-01-09,Z0085,118272,115387,110630,30660,263,116.58,79970,72.29
2024-01-09,Z0035,114570,111670,107060,16246,181,89.76,90814,84.83
2024-01-09,Z0090,113284,108298,104849,25872,262,98.75,78977,75.32
2024-01-09,Z0063,115122,110749,103732,29528,271,108.96,74204,71.53
2024-01-09,Z0095,106370,104790,97322,30219,268,112.76,67103,68.95
2024-01-09,Z0027,97999,95043,91040,18537,161,115.14,72503,79.64
2024-01-09,Z0023,92096,88132,85429,16392,167,98.16,69037,80.81
2024-01-09,Z0022,116201,111870,105137,35372,298,118.7,69765,66.36
2024-01-09,Z0096,105078,100712,93607,20223,195,103.71,73384,78.4
2024-01-09,Z0036,119312,115473,110089,20118,284,70.84,89971,81.73
2024-01-09,Z0041,103493,101808,93861,24719,235,105.19,69142,73.66
2024-01-09,Z0081,97531,96344,92725,27665,238,116.24,65060,70.16
2024-01-09,Z0082,103975,101991,95348,18455,178,103.68,76893,80.64
2024-01-09,Z0079,113252,109279,105848,10252,151,67.9,95596,90.31
2024-01-09,Z0033,99067,97450,92989,20752,176,117.91,72237,77.68
2024-01-09,Z0020,99557,97314,90316,19087,237,80.54,71229,78.87
2024-01-09,Z0064,90162,87188,81897,15822,171,92.53,66075,80.68
2024-01-09,Z0099,98461,96830,93925,22263,246,90.5,71662,76.3
2024-01-09,Z0075,122591,118120,112867,25071,267,93.9,87796,77.79
2024-01-09,Z0042,124782,122141,119937,20119,179,112.4,99818,83.23
2024-01-09,Z0057,120508,118257,114538,29283,260,112.63,85255,74.43
2024-01-09,Z0055,120314,116671,112374,18109,260,69.65,94265,83.89
2024-01-09,Z0049,128328,123724,121035,31852,293,108.71,89183,73.68
2024-01-09,Z0072,126768,123758,118617,26622,257,103.59,91995,77.56
2024-01-10,Z0017,121358,118936,116265,18531,281,65.95,97734,84.06
2024-01-10,Z0050,97927,93653,90482,23004,213,108.0,67478,74.58
2024-01-10,Z0060,101918,99975,96526,16621,159,104.54,79905,82.78
2024-01-10,Z0076,101929,98390,92431,18907,195,96.96,73524,79.54
2024-01-10,Z0003,112669,110333,104073,17483,215,81.32,86590,83.2
2024-01-10,Z0109,108745,105677,98476,14955,162,92.32,83521,84.81
2024-01-10,Z0001,118228,114026,108356,26056,235,110.88,82300,75.95
2024-01-10,Z0011,124521,120490,116138,12858,207,62.12,103280,88.93
2024-01-10,Z0108,108322,106952,98976,17110,163,104.97,81866,82.71
2024-01-10,Z0043,119055,116124,113700,27189,270,100.7,86511,76.09
2024-01-10,Z0026,96304,92055,85331,20196,293,68.93,65135,76.33
2024-01-10,Z0093,114259,112365,109768,24659,219,112.6,85109,77.54
2024-01-10,Z0024,109446,106110,99422,16870,250,67.48,82552,83.03
2024-01-10,Z0019,99879,95235,92663,22599,260,86.92,70064,75.61
2024-01-10,Z0088,97521,94446,90356,18052,169,106.82,72304,80.02
2024-01-10,Z0077,111008,108375,101314,18559,186,99.78,82755,81.68
2024-01-10,Z0040,102485,98828,93180,20653,203,101.74,72527,77.84
2024-01-10,Z0107,103140,98552,95015,18398,298,61.74,76617,80.64
2024-01-10,Z0008,104357,100174,92998,10844,153,70.88,82154,88.34
2024-01-10,Z0009,93137,89248,87151,14219,169,84.14,72932,83.68
2024-01-10,Z0111,101407,98504,91974,19549,220,88.86,72425,78.75
2024-01-10,Z0103,102924,98174,93017,16854,163,103.4,76163,81.88
2024-01-10,Z0061,98535,96218,89552,16838,229,73.53,72714,81.2
2024-01-10,Z0028,106994,104267,99977,17750,281,63.17,82227,82.25
2024-01-10,Z0029,124622,121014,113959,17402,173,100.59,96557,84.73
2024-01-10,Z0037,108708,107177,104000,22206,231,96.13,81794,78.65
2024-01-10,Z0074,99283,96382,89403,16579,209,79.33,72824,81.46
2024-01-10,Z0051,120933,118255,113464,13699,212,64.62,99765,87.93
2024-01-10,Z0098,120932,117806,114057,30414,299,101.72,83643,73.33
2024-01-10,Z0073,104939,103158,98110,24095,225,107.09,74015,75.44
2024-01-10,Z0083,96823,93718,87851,28547,266,107.32,59304,67.51
2024-01-10,Z0053,129961,128081,121539,14516,168,86.41,107023,88.06
2024-01-10,Z0104,124881,119889,112010,19364,243,79.69,92646,82.71
2024-01-10,Z0045,103565,98595,94604,24275,295,82.29,70329,74.34
2024-01-10,Z0105,115643,111475,107898,25123,262,95.89,82775,76.72
2024-01-10,Z0089,108658,106885,103071,23500,196,119.9,79571,77.2
2024-01-10,Z0069,113128,109702,102405,26312,267,98.55,76093,74.31
2024-01-10,Z0002,128314,123328,116926,28885,294,98.25,88041,75.3
2024-01-10,Z0046,119450,115899,110242,31820,297,107.14,78422,71.14
2024-01-10,Z0034,123243,120923,116712,24700,292,84.59,92012,78.84
2024-01-10,Z0025,97239,93625,86625,23796,227,104.83,62829,72.53
2024-01-10,Z0100,111038,106056,101771,23766,252,94.31,78005,76.65
2024-01-10,Z0091,127991,125758,119195,21148,293,72.18,98047,82.26
2024-01-10,Z0006,109909,105570,100748,24943,210,118.78,75805,75.24
2024-01-10,Z0062,127711,124277,119353,9358,152,61.57,109995,92.16
2024-01-10,Z0092,90258,88976,81231,24929,262,95.15,56302,69.31
2024-01-10,Z0059,91898,90859,85883,20393,267,76.38,65490,76.25
2024-01-10,Z0110,109584,107570,104958,26629,230,115.78,78329,74.63
2024-01-10,Z0068,107071,102381,99769,23288,200,116.44,76481,76.66
2024-01-10,Z0101,92307,88270,83257,15783,184,85.78,67474,81.04
2024-01-10,Z0018,95906,92315,87619,24093,218,110.52,63526,72.5
2024-01-10,Z0070,105149,100191,92943,17049,198,86.11,75894,81.66
2024-01-10,Z0065,115150,110970,107060,15763,154,102.36,91297,85.28
2024-01-10,Z0058,91283,89360,86235,15496,239,64.84,70739,82.03
2024-01-10,Z0067,91529,88771,85177,16880,188,89.79,68297,80.18
2024-01-10,Z0048,98438,93727,90167,29693,278,106.81,60474,67.07
2024-01-10,Z0031,116819,111955,108016,26376,249,105.93,81640,75.58
2024-01-10,Z0086,114217,109764,104695,14186,209,67.88,90509,86.45
2024-01-10,Z0052,113172,111946,106399,21646,206,105.08,84753,79.66
2024-01-10,Z0030,122220,120956,117561,11248,185,60.8,106313,90.43
2024-01-10,Z0080,120129,118484,110970,16108,257,62.68,94862,85.48
2024-01-10,Z0084,111953,107963,100480,17789,235,75.7,82691,82.3
2024-01-10,Z0032,116475,112971,108199,12220,163,74.97,95979,88.71
2024-01-10,Z0078,106087,103838,96761,18839,229,82.27,77922,80.53
2024-01-10,Z0005,99346,97759,91188,28225,255,110.69,62963,69.05
2024-01-10,Z0007,94079,89731,83900,13998,219,63.92,69902,83.32
2024-01-10,Z0012,115817,114628,107092,21570,194,111.19,85522,79.86
2024-01-10,Z0021,115556,112858,109143,16322,256,63.76,92821,85.05
2024-01-10,Z0039,96450,94508,88075,17497,256,68.35,70578,80.13
2024-01-10,Z0054,95433,93335,89009,10169,156,65.19,78840,88.58
2024-01-10,Z0047,101439,99544,95870,17902,292,61.31,77968,81.33
2024-01-10,Z0016,101101,96247,93317,20100,297,67.68,73217,78.46
2024-01-10,Z0014,102576,100853,95913,18815,298,63.14,77098,80.38
2024-01-10,Z0004,112433,110344,103766,20339,269,75.61,83427,80.4
2024-01-10,Z0015,99127,95832,93677,18472,206,89.67,75205,80.28
2024-01-10,Z0106,91958,88457,80678,12816,170,75.39,67862,84.11
2024-01-10,Z0056,118795,115747,108684,28982,280,103.51,79702,73.33
2024-01-10,Z0102,126598,124744,122105,17392,198,87.84,104713,85.76
2024-01-10,Z0013,99794,96231,93790,27803,238,116.82,65987,70.36
2024-01-10,Z0010,112424,109586,101661,23400,289,80.97,78261,76.98
2024-01-10,Z0094,127396,124122,120786,19556,266,73.52,101230,83.81
2024-01-10,Z0044,118276,116328,110955,22226,220,101.03,88729,79.97
2024-01-10,Z0066,98179,93454,90995,16634,182,91.4,74361,81.72
2024-01-10,Z0097,113952,112402,110010,15464,210,73.64,94546,85.94
2024-01-10,Z0087,119516,115238,110981,18296,177,103.37,92685,83.51
2024-01-10,Z0071,111125,106803,102349,21838,235,92.93,80511,78.66
2024-01-10,Z0112,107761,103826,99229,16030,247,64.9,83199,83.85
2024-01-10,Z0038,90141,86482,79886,22002,247,89.08,57884,72.46
2024-01-10,Z0085,99031,95282,89664,16019,234,68.46,73645,82.13
2024-01-10,Z0035,128429,125383,119466,18981,171,111.0,100485,84.11
2024-01-10,Z0090,112010,110415,106511,14157,215,65.85,92354,86.71
2024-01-10,Z0063,98472,97049,90684,24820,293,84.71,65864,72.63
2024-01-10,Z0095,94249,90588,86838,28759,274,104.96,58079,66.88
2024-01-10,Z0027,108351,107269,102323,14341,225,63.74,87982,85.98
2024-01-10,Z0023,111778,106994,102663,20267,187,108.38,82396,80.26
2024-01-10,Z0022,95075,91855,86066,34061,287,118.68,52005,60.42
2024-01-10,Z0096,97230,93086,88276,19046,212,89.84,69230,78.42
2024-01-10,Z0036,103947,101549,94821,13669,181,75.52,81152,85.58
2024-01-10,Z0041,103074,99084,92591,15664,169,92.69,76927,83.08
2024-01-10,Z0081,124228,121376,116653,22873,217,105.41,93780,80.39
2024-01-10,Z0082,121655,118143,115858,21108,292,72.29,94750,81.78
2024-01-10,Z0079,96816,92369,84596,25711,228,112.77,58885,69.61
2024-01-10,Z0033,119492,116730,111682,18154,241,75.33,93528,83.74
2024-01-10,Z0020,122698,119317,115048,23857,274,87.07,91191,79.26
2024-01-10,Z0064,122808,120077,118010,21743,207,105.04,96267,81.58
2024-01-10,Z0099,104849,99905,92188,16147,262,61.63,76041,82.48
2024-01-10,Z0075,95374,93680,89156,32074,280,114.55,57082,64.02
2024-01-10,Z0042,99277,95349,90870,20526,246,83.44,70344,77.41
2024-01-10,Z0057,99885,96570,89416,12759,155,82.32,76657,85.73
2024-01-10,Z0055,90778,86131,79542,18804,172,109.33,60738,76.36
2024-01-10,Z0049,91492,88702,86042,25592,296,86.46,60450,70.26
2024-01-10,Z0072,103615,101316,95376,11556,160,72.23,83820,87.88
2024-01-11,Z0017,97851,93791,89747,14637,223,65.64,75110,83.69
2024-01-11,Z0050,97368,92852,85409,17985,190,94.66,67424,78.94
2024-01-11,Z0060,115634,113658,107081,18425,234,78.74,88656,82.79
2024-01-11,Z0076,113852,112510,109063,23955,286,83.76,85108,78.04
2024-01-11,Z0003,116955,113470,107811,23076,253,91.21,84735,78.6
2024-01-11,Z0109,96317,92711,90185,21265,209,101.75,68920,76.42
2024-01-11,Z0001,116649,114830,112425,11263,161,69.96,101162,89.98
2024-01-11,Z0011,104567,100987,97414,25517,229,111.43,71897,73.81
2024-01-11,Z0108,120483,118979,113239,17302,152,113.83,95937,84.72
2024-01-11,Z0043,102466,101335,97489,30466,256,119.01,67023,68.75
2024-01-11,Z0026,107862,104467,101696,17236,278,62.0,84460,83.05
2024-01-11,Z0093,111909,108786,106208,17841,157,113.64,88367,83.2
2024-01-11,Z0024,101093,98578,96385,29817,273,109.22,66568,69.06
2024-01-11,Z0019,124775,122590,118196,21605,250,86.42,96591,81.72
2024-01-11,Z0088,101190,98806,95014,16837,259,65.01,78177,82.28
2024-01-11,Z0077,122327,120217,114212,12137,181,67.06,102075,89.37
2024-01-11,Z0040,92261,87525,81732,26009,288,90.31,55723,68.18
2024-01-11,Z0107,116512,112892,106017,19684,165,119.3,86333,81.43
2024-01-11,Z0008,118933,117204,110826,30714,258,119.05,80112,72.29
2024-01-11,Z0009,109835,108474,101938,17596,170,103.51,84342,82.74
2024-01-11,Z0111,100332,97688,92888,18332,153,119.82,74556,80.26
2024-01-11,Z0103,119538,117091,114950,14503,208,69.73,100447,87.38
2024-01-11,Z0061,95410,92955,84984,17812,176,101.21,67172,79.04
2024-01-11,Z0028,120519,117807,111011,25659,280,91.64,85352,76.89
2024-01-11,Z0029,107709,105829,102616,19032,174,109.38,83584,81.45
2024-01-11,Z0037,107543,105989,99490,22753,275,82.74,76737,77.13
2024-01-11,Z0074,127755,123843,117146,17244,158,109.14,99902,85.28
2024-01-11,Z0051,120502,119162,113334,29038,283,102.61,84296,74.38
2024-01-11,Z0098,107087,105770,98288,23832,270,88.27,74456,75.75
2024-01-11,Z0073,117005,113725,109925,22502,257,87.56,87423,79.53
2024-01-11,Z0083,95463,92891,85979,31581,280,112.79,54398,63.27
2024-01-11,Z0053,94648,90048,87193,12606,179,70.43,74587,85.54
2024-01-11,Z0104,125634,120992,118810,11352,170,66.78,107458,90.45
2024-01-11,Z0045,93112,90538,84046,14801,183,80.88,69245,82.39
2024-01-11,Z0105,112207,108381,104864,24238,231,104.93,80626,76.89
2024-01-11,Z0089,106018,104112,100756,16728,172,97.26,84028,83.4
2024-01-11,Z0069,98210,93807,87128,31179,299,104.28,55949,64.21
2024-01-11,Z0002,102743,98739,95607,22687,257,88.28,72920,76.27
2024-01-11,Z0046,96588,92277,86905,12339,164,75.24,74566,85.8
2024-01-11,Z0034,123755,119434,112819,12299,182,67.58,100520,89.1
2024-01-11,Z0025,103146,101973,94511,10952,165,66.38,83559,88.41
2024-01-11,Z0100,125820,122342,119616,13816,196,70.49,105800,88.45
2024-01-11,Z0091,93760,91050,87175,21868,297,73.63,65307,74.91
2024-01-11,Z0006,113377,110696,104663,15250,236,64.62,89413,85.43
2024-01-11,Z0062,128211,126222,120478,21956,216,101.65,98522,81.78
2024-01-11,Z0092,114995,113402,109628,15350,196,78.32,94278,86.0
2024-01-11,Z0059,100651,98716,91513,10538,170,61.99,80975,88.48
2024-01-11,Z0110,119808,115000,112669,22477,266,84.5,90192,80.05
2024-01-11,Z0068,114306,110604,104598,33238,291,114.22,71360,68.22
2024-01-11,Z0101,95889,93931,88063,31152,294,105.96,56911,64.63
2024-01-11,Z0018,110584,109383,104886,15760,248,63.55,89126,84.97
2024-01-11,Z0070,124610,121744,117748,30209,264,114.43,87539,74.34
2024-01-11,Z0065,99101,97892,91234,20013,240,83.39,71221,78.06
2024-01-11,Z0058,101381,97621,89962,17085,195,87.62,72877,81.01
2024-01-11,Z0067,107154,102999,98498,20642,249,82.9,77856,79.04
2024-01-11,Z0048,101777,99149,91352,15597,184,84.77,75755,82.93
2024-01-11,Z0031,123154,120219,114798,20143,227,88.74,94655,82.45
2024-01-11,Z0086,96439,93134,85934,16380,262,62.52,69554,80.94
2024-01-11,Z0052,118669,117402,112936,14606,237,61.63,98330,87.07
2024-01-11,Z0030,92282,89426,85428,19276,251,76.8,66152,77.44
2024-01-11,Z0080,121705,119325,116089,27461,232,118.37,88628,76.34
2024-01-11,Z0084,127437,126389,123239,29467,280,105.24,93772,76.09
2024-01-11,Z0032,129832,125482,122051,10811,177,61.08,111240,91.14
2024-01-11,Z0078,128392,124027,120208,21401,220,97.28,98807,82.2
2024-01-11,Z0005,100516,98055,94925,17380,222,78.29,77545,81.69
2024-01-11,Z0007,125426,120926,118552,24645,268,91.96,93907,79.21
2024-01-11,Z0012,124888,121867,116162,18878,168,112.37,97284,83.75
2024-01-11,Z0021,126027,121592,117703,21275,291,73.11,96428,81.92
2024-01-11,Z0039,124591,122117,117875,13460,210,64.1,104415,88.58
2024-01-11,Z0054,103467,99224,92064,11235,179,62.77,80829,87.8
2024-01-11,Z0047,93134,90064,87705,20721,269,77.03,66984,76.37
2024-01-11,Z0016,105434,101827,97786,27906,291,95.9,69880,71.46
2024-01-11,Z0014,91141,88506,81007,23741,227,104.59,57266,70.69
2024-01-11,Z0004,110384,107441,100667,24440,217,112.63,76227,75.72
2024-01-11,Z0015,126129,122642,117662,15110,151,100.07,102552,87.16
2024-01-11,Z0106,106390,102123,98532,20828,259,80.42,77704,78.86
2024-01-11,Z0056,111312,107048,102442,19131,269,71.12,83311,81.33
2024-01-11,Z0102,95906,91166,85893,12271,165,74.37,73622,85.71
2024-01-11,Z0013,107297,104286,100844,20205,262,77.12,80639,79.96
2024-01-11,Z0010,101738,100613,93701,15290,161,94.97,78411,83.68
2024-01-11,Z0094,101120,98291,95716,22865,213,107.35,72851,76.11
2024-01-11,Z0044,112852,110437,107508,19018,298,63.82,88490,82.31
2024-01-11,Z0066,101951,97252,93789,12372,169,73.21,81417,86.81
2024-01-11,Z0097,119504,117450,109706,28642,286,100.15,81064,73.89
2024-01-11,Z0087,108284,105827,102428,13163,214,61.51,89265,87.15
2024-01-11,Z0071,109799,108357,102707,20255,236,85.83,82452,80.28
2024-01-11,Z0112,94652,89809,86631,25794,225,114.64,60837,70.23
2024-01-11,Z0038,97597,94560,88102,13377,196,68.25,74725,84.82
2024-01-11,Z0085,96591,94334,88700,33610,296,113.55,55090,62.11
2024-01-11,Z0035,116417,113108,105162,16995,242,70.23,88167,83.84
2024-01-11,Z0090,92169,88997,81329,16639,170,97.88,64690,79.54
2024-01-11,Z0063,96313,95190,90032,18138,169,107.33,71894,79.85
2024-01-11,Z0095,113173,110442,107657,28265,281,100.59,79392,73.75
2024-01-11,Z0027,96139,92891,88475,15966,241,66.25,72509,81.95
2024-01-11,Z0023,115372,114296,108142,32055,299,107.21,76087,70.36
2024-01-11,Z0022,104973,102450,98514,21412,216,99.13,77102,78.27
2024-01-11,Z0096,126575,122520,119219,25108,240,104.62,94111,78.94
2024-01-11,Z0036,117716,113480,109128,11421,150,76.14,97707,89.53
2024-01-11,Z0041,91932,88211,85847,17590,155,113.49,68257,79.51
2024-01-11,Z0081,111300,108898,104508,18342,294,62.39,86166,82.45
2024-01-11,Z0082,99569,97130,91950,9724,155,62.74,82226,89.42
2024-01-11,Z0079,94857,90289,87949,21184,285,74.33,66765,75.91
2024-01-11,Z0033,106766,104763,101207,30163,255,118.29,71044,70.2
2024-01-11,Z0020,98491,97353,94995,21387,242,88.38,73608,77.49
2024-01-11,Z0064,99714,95258,91631,17798,248,71.77,73833,80.58
2024-01-11,Z0099,120654,118351,111347,15980,184,86.85,95367,85.65
2024-01-11,Z0075,116762,114767,109597,16873,233,72.42,92724,84.6
2024-01-11,Z0042,110219,105298,101147,26743,290,92.22,74404,73.56
2024-01-11,Z0057,99429,96645,90910,11971,198,60.46,78939,86.83
2024-01-11,Z0055,129673,125839,119579,17727,285,62.2,101852,85.18
2024-01-11,Z0049,108951,106644,103988,21045,273,77.09,82943,79.76
2024-01-11,Z0072,125428,122217,118308,20334,188,108.16,97974,82.81
2024-01-12,Z0017,100238,97127,91965,17683,211,83.81,74282,80.77
2024-01-12,Z0050,91140,88251,85985,23529,203,115.91,62456,72.64
2024-01-12,Z0060,116421,113713,108083,17222,158,109.0,90861,84.07
2024-01-12,Z0076,109595,106302,100570,19209,198,97.02,81361,80.9
2024-01-12,Z0003,116086,114611,111635,21780,237,91.9,89855,80.49
2024-01-12,Z0109,91207,89164,85204,18811,208,90.44,66393,77.92
2024-01-12,Z0001,90557,88540,80839,11738,190,61.78,69101,85.48
2024-01-12,Z0011,122272,120390,116196,10030,160,62.69,106166,91.37
2024-01-12,Z0108,127529,123154,118487,19552,288,67.89,98935,83.5
2024-01-12,Z0043,128635,124768,117809,13632,195,69.91,104177,88.43
2024-01-12,Z0026,102869,98799,92009,26674,257,103.79,65335,71.01
2024-01-12,Z0093,128115,123942,120332,25295,221,114.46,95037,78.98
2024-01-12,Z0024,118064,115825,111371,24889,258,96.47,86482,77.65
2024-01-12,Z0019,110878,107932,101122,20003,194,103.11,81119,80.22
2024-01-12,Z0088,102991,99183,93358,17547,157,111.77,75811,81.2
2024-01-12,Z0077,126304,123590,117788,24319,236,103.05,93469,79.35
2024-01-12,Z0040,118753,117150,113180,23579,233,101.2,89601,79.17
2024-01-12,Z0107,112190,109144,103322,18017,217,83.03,85305,82.56
2024-01-12,Z0008,123132,121970,116851,27533,276,99.76,89318,76.44
2024-01-12,Z0009,124631,123516,119132,28350,296,95.78,90782,76.2
2024-01-12,Z0111,105072,100137,93202,26566,233,114.02,66636,71.5
2024-01-12,Z0103,104482,99836,92394,14582,225,64.81,77812,84.22
2024-01-12,Z0061,92490,88606,81474,30657,292,104.99,50817,62.37
2024-01-12,Z0028,115518,110953,107229,15116,151,100.11,92113,85.9
2024-01-12,Z0029,116910,113143,110006,25092,254,98.79,84914,77.19
2024-01-12,Z0037,117103,116082,110662,19124,200,95.62,91538,82.72
2024-01-12,Z0074,95845,94163,88257,14330,159,90.13,73927,83.76
2024-01-12,Z0051,109337,106504,102137,22960,200,114.8,79177,77.52
2024-01-12,Z0098,102413,101137,97138,18700,270,69.26,78438,80.75
2024-01-12,Z0073,107611,104370,98618,15722,152,103.44,82896,84.06
2024-01-12,Z0083,105906,104211,100902,30363,266,114.15,70539,69.91
2024-01-12,Z0053,110536,105731,100497,25771,280,92.04,74726,74.36
2024-01-12,Z0104,102306,97865,93554,20638,189,109.2,72916,77.94
2024-01-12,Z0045,109225,108113,102554,12509,161,77.7,90045,87.8
2024-01-12,Z0105,101590,100049,95355,13922,214,65.06,81433,85.4
2024-01-12,Z0089,102866,100778,95415,16845,250,67.38,78570,82.35
2024-01-12,Z0069,122792,120220,115262,14446,198,72.96,100816,87.47
2024-01-12,Z0002,110620,107853,101110,18748,172,109.0,82362,81.46
2024-01-12,Z0046,98068,94833,92633,20708,187,110.74,71925,77.65
2024-01-12,Z0034,101390,100134,94387,21964,256,85.8,72423,76.73
2024-01-12,Z0025,119218,115977,110802,16035,248,64.66,94767,85.53
2024-01-12,Z0100,118182,113846,106949,17400,222,78.38,89549,83.73
2024-01-12,Z0091,98605,95591,92210,25858,271,95.42,66352,71.96
2024-01-12,Z0006,91098,86672,81017,27730,257,107.9,53287,65.77
2024-01-12,Z0062,114322,112413,110226,24067,228,105.56,86159,78.17
2024-01-12,Z0092,100207,97894,93802,13610,172,79.13,80192,85.49
2024-01-12,Z0059,118220,115090,107848,11965,197,60.74,95883,88.91
2024-01-12,Z0110,98549,95998,88813,12699,206,61.65,76114,85.7
2024-01-12,Z0068,105271,102591,98169,27654,273,101.3,70515,71.83
2024-01-12,Z0101,102449,97632,91087,12811,183,70.01,78276,85.94
2024-01-12,Z0018,100350,97400,92845,10695,156,68.56,82150,88.48
2024-01-12,Z0070,92951,90713,87740,21670,205,105.71,66070,75.3
2024-01-12,Z0065,94727,89762,82076,13576,196,69.27,68500,83.46
2024-01-12,Z0058,126469,122689,119101,28971,295,98.21,90130,75.68
2024-01-12,Z0067,118454,115086,107297,26334,275,95.76,80963,75.46
2024-01-12,Z0048,123204,119376,115820,26365,262,100.63,89455,77.24
2024-01-12,Z0031,113864,111560,107176,20027,218,91.87,87149,81.31
2024-01-12,Z0086,106566,102472,94907,25124,265,94.81,69783,73.53
2024-01-12,Z0052,105369,100814,93239,14192,214,66.32,79047,84.78
2024-01-12,Z0030,91589,89002,86343,17928,262,68.43,68415,79.24
2024-01-12,Z0080,90159,85206,82195,16068,218,73.71,66127,80.45
2024-01-12,Z0084,98244,94789,87648,21408,237,90.33,66240,75.58
2024-01-12,Z0032,108691,106463,98873,15265,224,68.15,83608,84.56
2024-01-12,Z0078,95585,93550,87848,21319,256,83.28,66529,75.73
2024-01-12,Z0005,128814,124453,117508,12280,200,61.4,105228,89.55
2024-01-12,Z0007,97927,96574,89380,14314,208,68.82,75066,83.99
2024-01-12,Z0012,97016,94277,86717,12136,179,67.8,74581,86.01
2024-01-12,Z0021,113545,110661,106852,18148,271,66.97,88704,83.02
2024-01-12,Z0039,93167,88370,84029,21523,273,78.84,62506,74.39
2024-01-12,Z0054,112736,108322,101115,20449,236,86.65,80666,79.78
2024-01-12,Z0047,104087,101127,96690,18303,167,109.6,78387,81.07
2024-01-12,Z0016,105275,103387,95436,17105,262,65.29,78331,82.08
2024-01-12,Z0014,95276,93609,86881,24475,208,117.67,62406,71.83
2024-01-12,Z0004,109008,106366,100134,24440,294,83.13,75694,75.59
2024-01-12,Z0015,95793,94366,86795,15814,171,92.48,70981,81.78
2024-01-12,Z0106,121331,116410,113592,18204,198,91.94,95388,83.97
2024-01-12,Z0056,115682,112458,110261,27273,258,105.71,82988,75.27
2024-01-12,Z0102,122441,120971,117023,30004,272,110.31,87019,74.36
2024-01-12,Z0013,116586,111786,104785,21879,280,78.14,82906,79.12
2024-01-12,Z0010,96318,95296,89500,18493,258,71.68,71007,79.34
2024-01-12,Z0094,102180,100946,93726,18848,234,80.55,74878,79.89
2024-01-12,Z0044,114427,112905,105001,20058,170,117.99,84943,80.9
2024-01-12,Z0066,118099,116669,109781,23357,252,92.69,86424,78.72
2024-01-12,Z0097,99821,97085,90457,26362,278,94.83,64095,70.86
2024-01-12,Z0087,106211,102185,94343,20756,173,119.98,73587,78.0
2024-01-12,Z0071,91316,87459,80451,28295,290,97.57,52156,64.83
2024-01-12,Z0112,107508,104983,97560,20862,288,72.44,76698,78.62
2024-01-12,Z0038,105206,101619,98596,17275,166,104.07,81321,82.48
2024-01-12,Z0085,112056,109678,104304,22499,231,97.4,81805,78.43
2024-01-12,Z0035,91519,88838,86612,12109,168,72.08,74503,86.02
2024-01-12,Z0090,95355,93483,90592,16117,234,68.88,74475,82.21
2024-01-12,Z0063,128342,126306,122049,13633,154,88.53,108416,88.83
2024-01-12,Z0095,117364,115968,108749,19667,267,73.66,89082,81.92
2024-01-12,Z0027,116654,112709,105965,20358,213,95.58,85607,80.79
2024-01-12,Z0023,110808,106571,98993,25522,247,103.33,73471,74.22
2024-01-12,Z0022,124773,121757,116586,21991,196,112.2,94595,81.14
2024-01-12,Z0096,100860,97982,94786,31215,298,104.75,63571,67.07
2024-01-12,Z0036,108156,106995,101019,16578,154,107.65,84441,83.59
2024-01-12,Z0041,108135,106360,98437,14873,169,88.01,83564,84.89
2024-01-12,Z0081,113554,111503,108564,19026,161,118.18,89538,82.47
2024-01-12,Z0082,109604,108065,101148,23168,264,87.76,77980,77.09
2024-01-12,Z0079,98547,93943,88620,12927,197,65.62,75693,85.41
2024-01-12,Z0033,123002,119728,116180,22473,201,111.81,93707,80.66
2024-01-12,Z0020,97480,94384,88171,22928,251,91.35,65243,74.0
2024-01-12,Z0064,100293,97620,90457,28134,292,96.35,62323,68.9
2024-01-12,Z0099,92100,87443,80790,20006,231,86.61,60784,75.24
2024-01-12,Z0075,118172,113424,108251,16585,153,108.4,91666,84.68
2024-01-12,Z0042,108199,103358,99353,23594,197,119.77,75759,76.25
2024-01-12,Z0057,98016,94101,87608,24584,221,111.24,63024,71.94
2024-01-12,Z0055,121881,120207,117821,22634,230,98.41,95187,80.79
2024-01-12,Z0049,124926,121265,117201,18232,245,74.42,98969,84.44
2024-01-12,Z0072,126021,124138,117502,23958,212,113.01,93544,79.61
2024-01-13,Z0017,121128,119389,115988,19757,218,90.63,96231,82.97
2024-01-13,Z0050,109643,105738,101461,18727,180,104.04,82734,81.54
2024-01-13,Z0060,110307,109189,103962,23304,263,88.61,80658,77.58
2024-01-13,Z0076,101950,98438,94287,14962,242,61.83,79325,84.13
2024-01-13,Z0003,101867,98122,92256,21934,216,101.55,70322,76.22
2024-01-13,Z0109,122245,117481,109680,18708,191,97.95,90972,82.94
2024-01-13,Z0001,95818,92596,87804,13858,170,81.52,73946,84.22
2024-01-13,Z0011,120116,115911,110449,13365,184,72.64,97084,87.9
2024-01-13,Z0108,110447,107688,104164,22165,206,107.6,81999,78.72
2024-01-13,Z0043,119336,118304,112279,12102,168,72.04,100177,89.22
2024-01-13,Z0026,110093,107034,99387,19199,175,109.71,80188,80.68
2024-01-13,Z0093,123487,119885,113306,13230,220,60.14,100076,88.32
2024-01-13,Z0024,110936,107729,101303,22522,216,104.27,78781,77.77
2024-01-13,Z0019,113303,112079,107049,17046,174,97.97,90003,84.08
2024-01-13,Z0088,118151,115672,110556,20022,292,68.57,90534,81.89
2024-01-13,Z0077,114770,109774,107286,30249,285,106.14,77037,71.81
2024-01-13,Z0040,92204,88547,81202,30068,277,108.55,51134,62.97
2024-01-13,Z0107,121131,116855,113753,16614,150,110.76,97139,85.39
2024-01-13,Z0008,128011,124493,121252,21239,253,83.95,100013,82.48
2024-01-13,Z0009,111607,110215,107585,11832,183,64.66,95753,89.0
2024-01-13,Z0111,101908,99061,94406,28043,277,101.24,66363,70.3
2024-01-13,Z0103,99171,97738,92336,19670,251,78.37,72666,78.7
2024-01-13,Z0061,106616,104064,96374,14731,221,66.66,81643,84.71
2024-01-13,Z0028,97659,93389,88980,11047,183,60.37,77933,87.58
2024-01-13,Z0029,101704,100679,93166,21193,232,91.35,71973,77.25
2024-01-13,Z0037,121226,116854,114394,16648,165,100.9,97746,85.45
2024-01-13,Z0074,103379,101373,95890,26471,294,90.04,69419,72.39
2024-01-13,Z0051,98682,93778,90706,27963,273,102.43,62743,69.17
2024-01-13,Z0098,122430,118819,113646,13839,215,64.37,99807,87.82
2024-01-13,Z0073,122983,118474,114751,16201,162,100.01,98550,85.88
2024-01-13,Z0083,108990,107832,101051,14065,183,76.86,86986,86.08
2024-01-13,Z0053,126081,122240,118464,22101,285,77.55,96363,81.34
2024-01-13,Z0104,106241,103189,95250,22679,269,84.31,72571,76.19
2024-01-13,Z0045,125063,122474,118778,10792,176,61.32,107986,90.91
2024-01-13,Z0105,101185,97716,93770,22327,202,110.53,71443,76.19
2024-01-13,Z0089,109167,104523,97282,28938,294,98.43,68344,70.25
2024-01-13,Z0069,129188,126607,122107,15586,162,96.21,106521,87.24
2024-01-13,Z0002,109029,105536,101187,17163,202,84.97,84024,83.04
2024-01-13,Z0046,91932,87638,83881,11724,174,67.38,72157,86.02
2024-01-13,Z0034,120722,118733,111096,23733,230,103.19,87363,78.64
2024-01-13,Z0025,91116,87549,82050,15739,181,86.96,66311,80.82
2024-01-13,Z0100,90492,86186,83567,17377,159,109.29,66190,79.21
2024-01-13,Z0091,117808,113016,107193,13054,203,64.31,94139,87.82
2024-01-13,Z0006,96474,93094,89548,19598,263,74.52,69950,78.11
2024-01-13,Z0062,103979,99416,95811,28321,259,109.35,67490,70.44
2024-01-13,Z0092,118328,115009,108334,21238,228,93.15,87096,80.4
2024-01-13,Z0059,115851,112244,107501,10491,153,68.57,97010,90.24
2024-01-13,Z0110,120527,115757,111264,11975,157,76.28,99289,89.24
2024-01-13,Z0068,113544,111189,103931,18631,268,69.52,85300,82.07
2024-01-13,Z0101,129954,126948,124079,12449,183,68.03,111630,89.97
2024-01-13,Z0018,120873,118460,115177,25515,247,103.3,89662,77.85
2024-01-13,Z0070,90619,88737,85941,26649,254,104.92,59292,68.99
2024-01-13,Z0065,93642,90470,85045,15084,228,66.16,69961,82.26
2024-01-13,Z0058,124064,122446,114516,15200,242,62.81,99316,86.73
2024-01-13,Z0067,114820,110925,107996,23424,245,95.61,84572,78.31
2024-01-13,Z0048,95366,93847,88635,22420,236,95.0,66215,74.71
2024-01-13,Z0031,108793,107786,103261,9456,157,60.23,93805,90.84
2024-01-13,Z0086,126191,123172,116582,25381,218,116.43,91201,78.23
2024-01-13,Z0052,113360,108862,101704,16822,213,78.98,84882,83.46
2024-01-13,Z0030,121312,120126,114459,31564,288,109.6,82895,72.42
2024-01-13,Z0080,118247,114446,106473,19512,256,76.22,86961,81.67
2024-01-13,Z0084,117691,116555,112087,28493,249,114.43,83594,74.58
2024-01-13,Z0032,112601,107982,104346,17206,200,86.03,87140,83.51
2024-01-13,Z0078,98155,93572,87563,30322,261,116.18,57241,65.37
2024-01-13,Z0005,109710,106492,98645,29758,294,101.22,68887,69.83
2024-01-13,Z0007,108601,105814,98847,20473,209,97.96,78374,79.29
2024-01-13,Z0012,108753,104115,99612,27047,269,100.55,72565,72.85
2024-01-13,Z0021,99135,96509,91672,12943,172,75.25,78729,85.88
2024-01-13,Z0039,117236,113010,108074,11497,162,70.97,96577,89.36
2024-01-13,Z0054,127212,122690,116743,18279,173,105.66,98464,84.34
2024-01-13,Z0047,108060,105864,99759,16694,166,100.57,83065,83.27
2024-01-13,Z0016,92787,88451,84990,13551,174,77.88,71439,84.06
2024-01-13,Z0014,109702,108036,100418,15048,170,88.52,85370,85.01
2024-01-13,Z0004,92176,87433,84833,34671,289,119.97,50162,59.13
2024-01-13,Z0015,117228,115902,110078,23990,294,81.6,86088,78.21
2024-01-13,Z0106,118482,116503,112052,16372,197,83.11,95680,85.39
2024-01-13,Z0056,123396,120767,115071,16826,190,88.56,98245,85.38
2024-01-13,Z0102,110058,105129,100364,28930,295,98.07,71434,71.17
2024-01-13,Z0013,94956,91953,89261,16037,254,63.14,73224,82.03
2024-01-13,Z0010,91105,87734,82726,13768,162,84.99,68958,83.36
2024-01-13,Z0094,105417,104264,96268,24635,290,84.95,71633,74.41
2024-01-13,Z0044,120099,115400,108015,20288,279,72.72,87727,81.22
2024-01-13,Z0066,102602,97816,94752,24906,222,112.19,69846,73.71
2024-01-13,Z0097,110584,107660,103747,22900,203,112.81,80847,77.93
2024-01-13,Z0087,115792,113368,108967,25066,249,100.67,83901,77.0
2024-01-13,Z0071,124540,121580,116800,19505,286,68.2,97295,83.3
2024-01-13,Z0112,102996,98669,91923,10536,156,67.54,81387,88.54
2024-01-13,Z0038,92871,90925,88265,11998,152,78.94,76267,86.41
2024-01-13,Z0085,112626,108991,104662,30077,298,100.93,74585,71.26
2024-01-13,Z0035,91132,89433,85395,14605,203,71.95,70790,82.9
2024-01-13,Z0090,129065,127514,121014,16214,249,65.12,104800,86.6
2024-01-13,Z0063,94557,91378,86540,10285,162,63.49,76255,88.12
2024-01-13,Z0095,99065,97982,94560,28547,267,106.92,66013,69.81
2024-01-13,Z0027,125948,124728,118753,15364,202,76.06,103389,87.06
2024-01-13,Z0023,129464,127073,121855,20458,202,101.28,101397,83.21
2024-01-13,Z0022,118783,117169,109492,13405,162,82.75,96087,87.76
2024-01-13,Z0096,118152,116678,114408,19081,173,110.3,95327,83.32
2024-01-13,Z0036,125236,122316,118926,15515,230,67.46,103411,86.95
2024-01-13,Z0041,104270,101034,93945,17762,287,61.89,76183,81.09
2024-01-13,Z0081,109991,106408,100335,23592,280,84.26,76743,76.49
2024-01-13,Z0082,109459,104553,102264,18983,166,114.36,83281,81.44
2024-01-13,Z0079,117056,113538,108286,16059,265,60.6,92227,85.17
2024-01-13,Z0033,97415,93740,91462,24698,271,91.14,66764,73.0
2024-01-13,Z0020,106964,105102,102849,16843,214,78.71,86006,83.62
2024-01-13,Z0064,127044,122143,115367,17552,165,106.38,97815,84.79
2024-01-13,Z0099,122252,117420,114721,17176,253,67.89,97545,85.03
2024-01-13,Z0075,104901,102552,99172,16635,176,94.52,82537,83.23
2024-01-13,Z0042,112918,110280,105124,24374,283,86.13,80750,76.81
2024-01-13,Z0057,101580,100369,92735,18989,182,104.34,73746,79.52
2024-01-13,Z0055,128578,127237,119303,12618,156,80.89,106685,89.42
2024-01-13,Z0049,100179,98336,93227,25916,275,94.24,67311,72.2
2024-01-13,Z0072,110466,107932,101417,19157,192,99.78,82260,81.11
2024-01-14,Z0017,109624,106636,101222,32023,284,112.76,69199,68.36
2024-01-14,Z0050,125517,123649,120514,12284,200,61.42,108230,89.81
2024-01-14,Z0060,120106,118901,112310,24592,224,109.79,87718,78.1
2024-01-14,Z0076,126218,122100,116289,16272,194,83.88,100017,86.01
2024-01-14,Z0003,117127,115082,108774,32025,281,113.97,76749,70.56
2024-01-14,Z0109,114885,111177,107186,23761,247,96.2,83425,77.83
2024-01-14,Z0001,105088,103817,98175,14496,228,63.58,83679,85.23
2024-01-14,Z0011,100014,96029,90756,17972,153,117.47,72784,80.2
2024-01-14,Z0108,127306,124097,117748,21264,286,74.35,96484,81.94
2024-01-14,Z0043,98712,96736,91014,24493,205,119.48,66521,73.09
2024-01-14,Z0026,93551,92542,87769,26380,224,117.77,61389,69.94
2024-01-14,Z0093,117128,113296,107389,18871,177,106.62,88518,82.43
2024-01-14,Z0024,112063,108580,101350,12204,166,73.52,89146,87.96
2024-01-14,Z0019,122920,120262,115298,29008,255,113.76,86290,74.84
2024-01-14,Z0088,101108,96935,92135,18597,174,106.88,73538,79.82
2024-01-14,Z0077,128078,125326,120716,14854,194,76.57,105862,87.7
2024-01-14,Z0040,102067,99963,95427,28940,253,114.39,66487,69.67
2024-01-14,Z0107,119566,117455,111256,24509,244,100.45,86747,77.97
2024-01-14,Z0008,110238,106071,100577,17271,214,80.71,83306,82.83
2024-01-14,Z0009,91914,87645,82573,16128,201,80.24,66445,80.47
2024-01-14,Z0111,115582,114176,106679,23362,206,113.41,83317,78.1
2024-01-14,Z0103,122934,121426,117765,12047,175,68.84,105718,89.77
2024-01-14,Z0061,126432,121943,115085,13835,154,89.84,101250,87.98
2024-01-14,Z0028,90680,87156,83036,22062,254,86.86,60974,73.43
2024-01-14,Z0029,111644,110063,103706,17242,203,84.94,86464,83.37
2024-01-14,Z0037,91363,89032,84740,13326,164,81.26,71414,84.27
2024-01-14,Z0074,91538,87130,84570,27311,271,100.78,57259,67.71
2024-01-14,Z0051,115675,112772,110598,21643,283,76.48,88955,80.43
2024-01-14,Z0098,116732,113502,107215,24827,235,105.65,82388,76.84
2024-01-14,Z0073,102112,98102,94605,21063,227,92.79,73542,77.74
2024-01-14,Z0083,109555,106988,103837,25380,290,87.52,78457,75.56
2024-01-14,Z0053,97619,94682,92314,10630,152,69.94,81684,88.48
2024-01-14,Z0104,94946,93904,89997,21508,242,88.88,68489,76.1
2024-01-14,Z0045,126258,122723,116550,28429,257,110.62,88121,75.61
2024-01-14,Z0105,116400,114107,107338,24100,224,107.59,83238,77.55
2024-01-14,Z0089,127564,125806,120420,13361,160,83.51,107059,88.9
2024-01-14,Z0069,109356,104434,97437,14570,219,66.53,82867,85.05
2024-01-14,Z0002,107376,105185,100799,25408,217,117.09,75391,74.79
2024-01-14,Z0046,108624,106148,100741,16626,197,84.4,84115,83.5
2024-01-14,Z0034,90389,88390,81770,21832,239,91.35,59938,73.3
2024-01-14,Z0025,91855,89349,86691,17003,225,75.57,69688,80.39
2024-01-14,Z0100,125531,120868,113882,27408,238,115.16,86474,75.93
2024-01-14,Z0091,122298,119817,114086,14859,204,72.84,99227,86.98
2024-01-14,Z0006,106835,103360,98138,20209,283,71.41,77929,79.41
2024-01-14,Z0062,116113,111666,106573,27437,264,103.93,79136,74.26
2024-01-14,Z0092,107266,105954,99886,31953,274,116.62,67933,68.01
2024-01-14,Z0059,101889,97034,91972,21429,256,83.71,70543,76.7
2024-01-14,Z0110,111074,106824,99495,27168,229,118.64,72327,72.69
2024-01-14,Z0068,127327,122416,120304,10942,157,69.7,109362,90.9
2024-01-14,Z0101,111515,107318,102940,16703,157,106.39,86237,83.77
2024-01-14,Z0018,116500,112146,110007,23920,243,98.44,86087,78.26
2024-01-14,Z0070,91424,87475,82307,20093,188,106.88,62214,75.59
2024-01-14,Z0065,100808,97861,94974,21881,233,93.91,73093,76.96
2024-01-14,Z0058,121802,117698,110261,26157,235,111.31,84104,76.28
2024-01-14,Z0067,106402,104677,101204,11720,193,60.73,89484,88.42
2024-01-14,Z0048,102253,98647,96196,23876,223,107.07,72320,75.18
2024-01-14,Z0031,129200,127036,119833,28052,253,110.88,91781,76.59
2024-01-14,Z0086,93765,90327,84017,18055,240,75.23,65962,78.51
2024-01-14,Z0052,99741,96479,91005,22725,270,84.17,68280,75.03
2024-01-14,Z0030,114703,111858,105003,25635,257,99.75,79368,75.59
2024-01-14,Z0080,112931,108831,100920,18138,159,114.08,82782,82.03
2024-01-14,Z0084,105166,101405,94949,21886,183,119.6,73063,76.95
2024-01-14,Z0032,119240,116825,109132,25147,238,105.66,83985,76.96
2024-01-14,Z0078,128556,127355,122986,18046,216,83.55,104940,85.33
2024-01-14,Z0005,106901,102260,94816,16481,266,61.96,78335,82.62
2024-01-14,Z0007,115917,114237,110249,29030,248,117.06,81219,73.67
2024-01-14,Z0012,104256,99454,91646,18367,240,76.53,73279,79.96
2024-01-14,Z0021,118230,114164,109730,17803,166,107.25,91927,83.78
2024-01-14,Z0039,112625,108209,100287,22042,265,83.18,78245,78.02
2024-01-14,Z0054,128401,125742,121109,20385,240,84.94,100724,83.17
2024-01-14,Z0047,112693,111672,109519,30016,263,114.13,79503,72.59
2024-01-14,Z0016,122182,117816,111502,30562,258,118.46,80940,72.59
2024-01-14,Z0014,119340,116822,112222,21324,236,90.36,90898,81.0
2024-01-14,Z0004,119267,114713,110299,11844,190,62.34,98455,89.26
2024-01-14,Z0015,106193,103756,98907,31809,271,117.38,67098,67.84
2024-01-14,Z0106,106194,104037,100295,19153,171,112.01,81142,80.9
2024-01-14,Z0056,91306,86457,80289,20593,217,94.9,59696,74.35
2024-01-14,Z0102,119231,114834,107994,27014,288,93.8,80980,74.99
2024-01-14,Z0013,126963,124881,120326,27118,298,91.0,93208,77.46
2024-01-14,Z0010,108689,107277,104189,19316,175,110.38,84873,81.46
2024-01-14,Z0094,92642,90465,83549,20944,258,81.18,62605,74.93
2024-01-14,Z0044,105438,101052,94295,22389,196,114.23,71906,76.26
2024-01-14,Z0066,92994,91435,86471,15887,189,84.06,70584,81.63
2024-01-14,Z0097,124039,121226,116311,30738,281,109.39,85573,73.57
2024-01-14,Z0087,108845,107821,105538,20935,233,89.85,84603,80.16
2024-01-14,Z0071,127164,125073,117947,19151,265,72.27,98796,83.76
2024-01-14,Z0112,107200,102992,100910,20283,285,71.17,80627,79.9
2024-01-14,Z0038,91920,87199,81708,28306,296,95.63,53402,65.36
2024-01-14,Z0085,101336,97028,92935,14121,195,72.42,78814,84.81
2024-01-14,Z0035,102905,98930,96755,16863,217,77.71,79892,82.57
2024-01-14,Z0090,95285,91581,84644,23507,278,84.56,61137,72.23
2024-01-14,Z0063,106753,103935,99834,18960,173,109.6,80874,81.01
2024-01-14,Z0095,102977,98487,94708,14040,173,81.16,80668,85.18
2024-01-14,Z0027,97674,95310,87782,10572,153,69.1,77210,87.96
2024-01-14,Z0023,119038,114696,107957,22660,265,85.51,85297,79.01
2024-01-14,Z0022,93676,90250,88178,18205,218,83.51,69973,79.35
2024-01-14,Z0096,114473,110511,103144,19395,211,91.92,83749,81.2
2024-01-14,Z0036,90859,86003,79865,16591,203,81.73,63274,79.23
2024-01-14,Z0041,125192,123128,118911,24386,206,118.38,94525,79.49
2024-01-14,Z0081,94017,90758,83146,20507,284,72.21,62639,75.34
2024-01-14,Z0082,118327,115241,112873,18308,234,78.24,94565,83.78
2024-01-14,Z0079,91134,88631,81076,17169,152,112.96,63907,78.82
2024-01-14,Z0033,127887,125289,120505,24383,235,103.76,96122,79.77
2024-01-14,Z0020,112520,110131,103967,16528,225,73.46,87439,84.1
2024-01-14,Z0064,95039,93238,88988,24754,290,85.36,64234,72.18
2024-01-14,Z0099,98252,96307,91297,22638,199,113.76,68659,75.2
2024-01-14,Z0075,107568,106238,102687,25690,250,102.76,76997,74.98
2024-01-14,Z0042,102625,99996,96669,22060,275,80.22,74609,77.18
2024-01-14,Z0057,116249,113888,110315,21246,196,108.4,89069,80.74
2024-01-14,Z0055,94370,92183,87817,13767,188,73.23,74050,84.32
2024-01-14,Z0049,104924,101373,95616,14293,171,83.59,81323,85.05
2024-01-14,Z0072,100626,97633,94764,20556,298,68.98,74208,78.31
2024-01-15,Z0017,121552,119538,115627,10677,165,64.71,104950,90.77
2024-01-15,Z0050,106986,102165,94270,18941,180,105.23,75329,79.91
2024-01-15,Z0060,123458,121965,119476,12677,181,70.04,106799,89.39
2024-01-15,Z0076,113248,109104,104548,12028,158,76.13,92520,88.5
2024-01-15,Z0003,119061,114371,112077,14136,159,88.91,97941,87.39
2024-01-15,Z0109,128256,124413,119501,15950,166,96.09,103551,86.65
2024-01-15,Z0001,116293,112697,105953,26746,260,102.87,79207,74.76
2024-01-15,Z0011,108257,106690,101432,27895,298,93.61,73537,72.5
2024-01-15,Z0108,125585,124141,118500,21937,214,102.51,96563,81.49
2024-01-15,Z0043,94458,91288,83981,16432,200,82.16,67549,80.43
2024-01-15,Z0026,108425,106746,102279,30263,276,109.65,72016,70.41
2024-01-15,Z0093,118273,113950,106212,17914,253,70.81,88298,83.13
2024-01-15,Z0024,95668,93310,91248,29433,272,108.21,61815,67.74
2024-01-15,Z0019,100751,98589,92820,28113,271,103.74,64707,69.71
2024-01-15,Z0088,97352,95124,88773,22187,275,80.68,66586,75.01
2024-01-15,Z0077,126412,124538,117621,17919,222,80.72,99702,84.77
2024-01-15,Z0040,116711,111804,106526,15486,155,99.91,91040,85.46
2024-01-15,Z0107,97296,95474,90400,10203,152,67.13,80197,88.71
2024-01-15,Z0008,103261,99280,91407,20516,198,103.62,70891,77.56
2024-01-15,Z0009,91637,87528,80068,30142,258,116.83,49926,62.35
2024-01-15,Z0111,95103,93179,90535,16846,214,78.72,73689,81.39
2024-01-15,Z0103,124800,121039,116971,14825,164,90.4,102146,87.33
2024-01-15,Z0061,121174,117164,112496,25497,245,104.07,86999,77.34
2024-01-15,Z0028,105954,104152,97093,17983,295,60.96,79110,81.48
2024-01-15,Z0029,102356,100204,98009,21185,192,110.34,76824,78.38
2024-01-15,Z0037,92187,87672,83342,23203,227,102.22,60139,72.16
2024-01-15,Z0074,116935,115190,109584,18027,163,110.6,91557,83.55
2024-01-15,Z0051,122828,118438,114525,26284,281,93.54,88241,77.05
2024-01-15,Z0098,104387,99460,91592,23749,232,102.37,67843,74.07
2024-01-15,Z0073,92591,91025,85090,19900,232,85.78,65190,76.61
2024-01-15,Z0083,116147,114526,111326,15653,176,88.94,95673,85.94
2024-01-15,Z0053,105721,104408,99554,19065,162,117.69,80489,80.85
2024-01-15,Z0104,101087,97943,94707,24801,296,83.79,69906,73.81
2024-01-15,Z0045,129740,128604,125575,30670,272,112.76,94905,75.58
2024-01-15,Z0105,108978,104868,102207,16526,238,69.44,85681,83.83
2024-01-15,Z0089,125240,121563,117255,16954,151,112.28,100301,85.54
2024-01-15,Z0069,122854,119342,114400,23783,264,90.09,90617,79.21
2024-01-15,Z0002,117886,115186,109516,16581,221,75.03,92935,84.86
2024-01-15,Z0046,125468,121749,116120,25272,268,94.3,90848,78.24
2024-01-15,Z0034,122115,120621,116974,19620,165,118.91,97354,83.23
2024-01-15,Z0025,95520,91202,85515,13947,221,63.11,71568,83.69
2024-01-15,Z0100,110929,109445,106800,16031,262,61.19,90769,84.99
2024-01-15,Z0091,104955,100866,93141,15838,202,78.41,77303,83.0
2024-01-15,Z0006,94757,93000,86616,14907,176,84.7,71709,82.79
2024-01-15,Z0062,94733,91451,88953,22651,283,80.04,66302,74.54
2024-01-15,Z0092,113501,111868,108195,23212,206,112.68,84983,78.55
2024-01-15,Z0059,114690,110711,103942,13973,218,64.1,89969,86.56
2024-01-15,Z0110,116829,112079,107785,16920,208,81.35,90865,84.3
2024-01-15,Z0068,93630,89825,87679,17108,199,85.97,70571,80.49
2024-01-15,Z0101,93453,92042,84259,16909,168,100.65,67350,79.93
2024-01-15,Z0018,128396,127260,121900,17244,272,63.4,104656,85.85
2024-01-15,Z0070,109389,104837,102819,16246,196,82.89,86573,84.2
2024-01-15,Z0065,125010,121633,114536,17927,182,98.5,96609,84.35
2024-01-15,Z0058,98640,95692,92747,27814,284,97.94,64933,70.01
2024-01-15,Z0067,120049,117527,111291,17418,163,106.86,93873,84.35
2024-01-15,Z0048,91920,87943,81755,29101,277,105.06,52654,64.4
2024-01-15,Z0031,102207,100969,98765,22770,297,76.67,75995,76.95
2024-01-15,Z0086,100799,98343,92003,26906,231,116.48,65097,70.76
2024-01-15,Z0052,94927,90539,85567,30180,254,118.82,55387,64.73
2024-01-15,Z0030,127158,123471,116520,19226,211,91.12,97294,83.5
2024-01-15,Z0080,96160,95090,87702,10987,166,66.19,76715,87.47
2024-01-15,Z0084,105810,103780,96347,13827,207,66.8,82520,85.65
2024-01-15,Z0032,123584,121458,118638,19692,211,93.33,98946,83.4
2024-01-15,Z0078,90192,87416,81771,23624,231,102.27,58147,71.11
2024-01-15,Z0005,102816,99598,97348,16689,220,75.86,80659,82.86
2024-01-15,Z0007,122130,117852,112152,14470,159,91.01,97682,87.1
2024-01-15,Z0012,120698,117235,109736,14004,184,76.11,95732,87.24
2024-01-15,Z0021,99359,96287,90394,25383,273,92.98,65011,71.92
2024-01-15,Z0039,129579,127483,122804,11737,171,68.64,111067,90.44
2024-01-15,Z0054,123272,120651,116179,13222,188,70.33,102957,88.62
2024-01-15,Z0047,100738,98351,93357,13154,169,77.84,80203,85.91
2024-01-15,Z0016,96773,91957,84639,28494,297,95.94,56145,66.33
2024-01-15,Z0014,90717,86233,79799,15268,233,65.53,64531,80.87
2024-01-15,Z0004,127825,126397,119403,16348,215,76.04,103055,86.31
2024-01-15,Z0015,94234,89470,84481,18708,183,102.23,65773,77.86
2024-01-15,Z0106,127405,124301,121046,21239,283,75.05,99807,82.45
2024-01-15,Z0056,113185,109703,107320,13839,159,87.04,93481,87.1
2024-01-15,Z0102,101999,97280,92699,23667,245,96.6,69032,74.47
2024-01-15,Z0013,92763,88965,80974,18667,249,74.97,62307,76.95
2024-01-15,Z0010,100531,96125,93394,16907,151,111.97,76487,81.9
2024-01-15,Z0094,120835,116963,111843,14342,214,67.02,97501,87.18
2024-01-15,Z0044,127548,126467,121863,15381,159,96.74,106482,87.38
2024-01-15,Z0066,114565,111183,108652,21671,208,104.19,86981,80.05
2024-01-15,Z0097,112463,111243,108609,11898,197,60.4,96711,89.05
2024-01-15,Z0087,116345,111541,107171,16674,171,97.51,90497,84.44
2024-01-15,Z0071,104162,103160,95347,10967,174,63.03,84380,88.5
2024-01-15,Z0112,98397,95542,89407,21782,262,83.14,67625,75.64
2024-01-15,Z0038,104394,100396,95775,11729,156,75.19,84046,87.75
2024-01-15,Z0085,112010,107367,102477,27248,232,117.45,75229,73.41
2024-01-15,Z0035,117769,113219,108553,24506,222,110.39,84047,77.42
2024-01-15,Z0090,98026,93541,88235,26611,255,104.36,61624,69.84
2024-01-15,Z0063,123665,121580,118301,18386,155,118.62,99915,84.46
2024-01-15,Z0095,104683,103013,99508,26424,294,89.88,73084,73.45
2024-01-15,Z0027,103006,100935,96980,15137,176,86.01,81843,84.39
2024-01-15,Z0023,111639,107367,105118,26879,234,114.87,78239,74.43
2024-01-15,Z0022,124660,120221,116368,19635,260,75.52,96733,83.13
2024-01-15,Z0096,125622,123119,117734,21963,242,90.76,95771,81.35
2024-01-15,Z0036,101763,96971,91545,28229,296,95.37,63316,69.16
2024-01-15,Z0041,114255,113212,107600,15406,166,92.81,92194,85.68
2024-01-15,Z0081,125386,123804,118641,14158,190,74.52,104483,88.07
2024-01-15,Z0082,125710,124491,120566,13528,188,71.96,107038,88.78
2024-01-15,Z0079,125740,121227,116779,27123,260,104.32,89656,76.77
2024-01-15,Z0033,118047,114273,111283,12106,196,61.77,99177,89.12
2024-01-15,Z0020,101138,98326,91373,19748,259,76.25,71625,78.39
2024-01-15,Z0064,90489,85933,78057,11666,183,63.75,66391,85.05
2024-01-15,Z0099,116069,111424,106533,17952,210,85.49,88581,83.15
2024-01-15,Z0075,126284,121944,119891,20340,211,96.4,99551,83.03
2024-01-15,Z0042,106999,104917,96973,21434,224,95.69,75539,77.9
2024-01-15,Z0057,123722,120289,116660,28452,243,117.09,88208,75.61
2024-01-15,Z0055,100973,97210,94561,32459,287,113.1,62102,65.67
2024-01-15,Z0049,126046,123687,119047,30188,276,109.38,88859,74.64
2024-01-15,Z0072,108945,104696,102326,19643,212,92.66,82683,80.8
2024-01-16,Z0017,123625,121835,115082,27162,280,97.01,87920,76.4
2024-01-16,Z0050,97485,93702,86214,16092,214,75.2,70122,81.33
2024-01-16,Z0060,106767,103658,97781,21909,240,91.29,75872,77.59
2024-01-16,Z0076,100744,99506,93216,16066,222,72.37,77150,82.76
2024-01-16,Z0003,102226,97933,90685,23628,256,92.3,67057,73.94
2024-01-16,Z0109,121709,117977,111726,29320,262,111.91,82406,73.76
2024-01-16,Z0001,90922,87007,82057,27975,246,113.72,54082,65.91
2024-01-16,Z0011,97957,95348,90302,17760,286,62.1,72542,80.33
2024-01-16,Z0108,123998,120563,116749,19815,234,84.68,96934,83.03
2024-01-16,Z0043,127701,124694,121331,15504,207,74.9,105827,87.22
2024-01-16,Z0026,110324,106937,104734,26026,263,98.96,78708,75.15
2024-01-16,Z0093,106544,101933,95446,19909,186,107.04,75537,79.14
2024-01-16,Z0024,115344,110596,106015,18283,167,109.48,87732,82.75
2024-01-16,Z0019,91093,87153,80653,32025,299,107.11,48628,60.29
2024-01-16,Z0088,115183,110437,102727,14597,153,95.41,88130,85.79
2024-01-16,Z0077,109259,105068,101231,17997,284,63.37,83234,82.22
2024-01-16,Z0040,123457,118698,113749,12525,203,61.7,101224,88.99
2024-01-16,Z0107,92103,90738,82920,29431,278,105.87,53489,64.51
2024-01-16,Z0008,106103,101265,94715,20414,270,75.61,74301,78.45
2024-01-16,Z0009,102391,101315,94990,12474,187,66.71,82516,86.87
2024-01-16,Z0111,122001,117666,113288,30227,282,107.19,83061,73.32
2024-01-16,Z0103,111372,106533,98864,24063,241,99.85,74801,75.66
2024-01-16,Z0061,125503,122429,117082,28274,258,109.59,88808,75.85
2024-01-16,Z0028,99867,98569,95613,15458,232,66.63,80155,83.83
2024-01-16,Z0029,99306,95779,91274,13184,218,60.48,78090,85.56
2024-01-16,Z0037,127228,123322,115528,21675,289,75.0,93853,81.24
2024-01-16,Z0074,118302,113831,109003,19106,205,93.2,89897,82.47
2024-01-16,Z0051,125618,123607,119101,17773,170,104.55,101328,85.08
2024-01-16,Z0098,94594,92645,86042,29731,271,109.71,56311,65.45
2024-01-16,Z0073,96644,92794,90629,14883,204,72.96,75746,83.58
2024-01-16,Z0083,123687,122574,117070,23902,204,117.17,93168,79.58
2024-01-16,Z0053,107375,102948,97109,18117,185,97.93,78992,81.34
2024-01-16,Z0104,107642,103129,97703,19453,255,76.29,78250,80.09
2024-01-16,Z0045,111188,106264,101068,25780,229,112.58,75288,74.49
2024-01-16,Z0105,120857,119519,114935,17547,210,83.56,97388,84.73
2024-01-16,Z0089,122835,120239,112579,23269,258,90.19,89310,79.33
2024-01-16,Z0069,94478,93460,88730,27298,299,91.3,61432,69.23
2024-01-16,Z0002,126289,123168,120596,15495,154,100.62,105101,87.15
2024-01-16,Z0046,129850,125114,117719,25094,225,111.53,92625,78.68
2024-01-16,Z0034,108642,104740,102090,12524,206,60.8,89566,87.73
2024-01-16,Z0025,95741,93748,89161,15583,178,87.55,73578,82.52
2024-01-16,Z0100,93262,90924,83928,16699,236,70.76,67229,80.1
2024-01-16,Z0091,112164,108337,100656,16202,195,83.09,84454,83.9
2024-01-16,Z0006,104211,101430,94198,17500,261,67.05,76698,81.42
2024-01-16,Z0062,92217,87678,84641,30705,294,104.44,53936,63.72
2024-01-16,Z0092,104026,102739,96761,24130,234,103.12,72631,75.06
2024-01-16,Z0059,120908,116947,111721,30385,283,107.37,81336,72.8
2024-01-16,Z0110,129605,126860,123762,16932,243,69.68,106830,86.32
2024-01-16,Z0068,115515,110799,105385,14689,182,80.71,90696,86.06
2024-01-16,Z0101,90570,85988,81084,19233,275,69.94,61851,76.28
2024-01-16,Z0018,103288,101083,96578,22021,271,81.26,74557,77.2
2024-01-16,Z0070,90917,88043,81115,19361,264,73.34,61754,76.13
2024-01-16,Z0065,96982,92651,88973,13922,177,78.66,75051,84.35
2024-01-16,Z0058,106999,105594,101845,16358,196,83.46,85487,83.94
2024-01-16,Z0067,113470,109702,103514,23721,296,80.14,79793,77.08
2024-01-16,Z0048,111133,106628,101153,32337,275,117.59,68816,68.03
2024-01-16,Z0031,94529,92394,86394,26336,221,119.17,60058,69.52
2024-01-16,Z0086,98566,94436,87274,24295,286,84.95,62979,72.16
2024-01-16,Z0052,111259,108940,105799,16924,168,100.74,88875,84.0
2024-01-16,Z0030,94627,90334,85644,20925,247,84.72,64719,75.57
2024-01-16,Z0080,93255,92166,84953,27213,278,97.89,57740,67.97
2024-01-16,Z0084,126876,122856,118999,18978,197,96.34,100021,84.05
2024-01-16,Z0032,115380,113436,108647,24705,213,115.99,83942,77.26
2024-01-16,Z0078,113989,109380,105770,12891,188,68.57,92879,87.81
2024-01-16,Z0005,114519,110596,104714,15879,175,90.74,88835,84.84
2024-01-16,Z0007,101413,97706,90558,13528,162,83.51,77030,85.06
2024-01-16,Z0012,113513,111588,104853,19944,198,100.73,84909,80.98
2024-01-16,Z0021,119299,115813,108550,18727,207,90.47,89823,82.75
2024-01-16,Z0039,115517,113688,105822,21531,202,106.59,84291,79.65
2024-01-16,Z0054,108950,106975,104021,22697,211,107.57,81324,78.18
2024-01-16,Z0047,91262,89311,86368,17467,174,100.39,68901,79.78
2024-01-16,Z0016,112615,108288,100658,26219,280,93.64,74439,73.95
2024-01-16,Z0014,119768,115790,109516,19500,266,73.31,90016,82.19
2024-01-16,Z0004,106848,104074,98780,13160,175,75.2,85620,86.68
2024-01-16,Z0015,129542,125670,122440,18075,174,103.88,104365,85.24
2024-01-16,Z0106,117230,115346,109541,20455,222,92.14,89086,81.33
2024-01-16,Z0056,121085,117762,110334,18810,214,87.9,91524,82.95
2024-01-16,Z0102,95750,91411,84371,25991,235,110.6,58380,69.19
2024-01-16,Z0013,125903,122046,119122,20565,257,80.02,98557,82.74
2024-01-16,Z0010,112418,110925,107379,25343,232,109.24,82036,76.4
2024-01-16,Z0094,112449,110355,105944,14428,164,87.98,91516,86.38
2024-01-16,Z0044,115338,112015,105870,17697,179,98.87,88173,83.28
2024-01-16,Z0066,122101,118326,111325,33662,295,114.11,77663,69.76
2024-01-16,Z0097,121647,120084,113206,14278,197,72.48,98928,87.39
2024-01-16,Z0087,109539,104569,100529,32102,285,112.64,68427,68.07
2024-01-16,Z0071,104119,102536,95121,29874,253,118.08,65247,68.59
2024-01-16,Z0112,127099,123996,120054,26208,265,98.9,93846,78.17
2024-01-16,Z0038,114685,113494,110591,19064,231,82.53,91527,82.76
2024-01-16,Z0085,123629,120014,116931,23153,194,119.35,93778,80.2
2024-01-16,Z0035,107033,105995,100384,20251,169,119.83,80133,79.83
2024-01-16,Z0090,105408,100917,98281,17019,272,62.57,81262,82.68
2024-01-16,Z0063,107420,106385,102237,15813,216,73.21,86424,84.53
2024-01-16,Z0095,101349,96762,91468,20554,213,96.5,70914,77.53
2024-01-16,Z0027,128225,125242,118981,17401,211,82.47,101580,85.37
2024-01-16,Z0023,108814,105935,99969,21602,209,103.36,78367,78.39
2024-01-16,Z0022,105735,101193,95480,21951,271,81.0,73529,77.01
2024-01-16,Z0096,113926,112916,108905,14822,245,60.5,94083,86.39
2024-01-16,Z0036,93373,90230,85730,27816,279,99.7,57914,67.55
2024-01-16,Z0041,124057,121610,116411,16313,198,82.39,100098,85.99
2024-01-16,Z0081,112765,109822,104639,17941,273,65.72,86698,82.85
2024-01-16,Z0082,104139,101670,94208,12606,197,63.99,81602,86.62
2024-01-16,Z0079,109520,105202,100420,24384,285,85.56,76036,75.72
2024-01-16,Z0033,115566,111005,104085,22132,207,106.92,81953,78.74
2024-01-16,Z0020,120134,116981,114756,22825,211,108.18,91931,80.11
2024-01-16,Z0064,117413,112433,105225,21840,207,105.51,83385,79.24
2024-01-16,Z0099,123455,121926,116484,24866,248,100.27,91618,78.65
2024-01-16,Z0075,98080,95658,91505,20176,193,104.54,71329,77.95
2024-01-16,Z0042,99486,96488,92962,21945,220,99.75,71017,76.39
2024-01-16,Z0057,111158,106562,101666,31303,276,113.42,70363,69.21
2024-01-16,Z0055,125871,122431,116296,22194,294,75.49,94102,80.92
2024-01-16,Z0049,121379,117090,111288,24077,280,85.99,87211,78.37
2024-01-16,Z0072,129892,127787,124943,27090,239,113.35,97853,78.32
2024-01-17,Z0017,104031,100783,98337,14641,211,69.39,83696,85.11
2024-01-17,Z0050,126683,122184,117075,16648,162,102.77,100427,85.78
2024-01-17,Z0060,107618,104127,96681,11903,165,72.14,84778,87.69
2024-01-17,Z0076,121480,120254,114111,14792,208,71.12,99319,87.04
2024-01-17,Z0003,113569,109610,102052,23851,279,85.49,78201,76.63
2024-01-17,Z0109,122954,119562,114685,25950,287,90.42,88735,77.37
2024-01-17,Z0001,125303,122371,117447,14797,229,64.62,102650,87.4
2024-01-17,Z0011,92032,89780,82271,10271,151,68.02,72000,87.52
2024-01-17,Z0108,127842,125230,118118,28857,264,109.31,89261,75.57
2024-01-17,Z0043,104523,101642,99373,34665,295,117.51,64708,65.12
2024-01-17,Z0026,91630,90321,85118,19995,262,76.32,65123,76.51
2024-01-17,Z0093,112523,109949,102758,17204,187,92.0,85554,83.26
2024-01-17,Z0024,91695,87437,82175,16688,210,79.47,65487,79.69
2024-01-17,Z0019,91445,88278,86059,30300,298,101.68,55759,64.79
2024-01-17,Z0088,106436,103679,96109,16083,162,99.28,80026,83.27
2024-01-17,Z0077,113963,111297,103941,21549,284,75.88,82392,79.27
2024-01-17,Z0040,96901,93116,90397,24640,281,87.69,65757,72.74
2024-01-17,Z0107,98597,94942,90648,19097,268,71.26,71551,78.93
2024-01-17,Z0008,98263,95410,91357,24795,233,106.42,66562,72.86
2024-01-17,Z0009,115805,113238,107556,19129,233,82.1,88427,82.21
2024-01-17,Z0111,117529,116143,108256,12926,177,73.03,95330,88.06
2024-01-17,Z0103,97243,95043,92217,16078,212,75.84,76139,82.57
2024-01-17,Z0061,102100,97327,95020,30893,274,112.75,64127,67.49
2024-01-17,Z0028,109800,107650,103316,21304,228,93.44,82012,79.38
2024-01-17,Z0029,119437,117713,112904,29990,269,111.49,82914,73.44
2024-01-17,Z0037,109942,108560,103083,24264,283,85.74,78819,76.46
2024-01-17,Z0074,105916,102230,97245,29342,259,113.29,67903,69.83
2024-01-17,Z0051,122369,121094,116547,25302,253,100.01,91245,78.29
2024-01-17,Z0098,117340,116004,112031,32653,295,110.69,79378,70.85
2024-01-17,Z0073,109363,107883,101915,24362,224,108.76,77553,76.1
2024-01-17,Z0083,123678,120682,115553,17546,274,64.04,98007,84.82
2024-01-17,Z0053,128215,125182,117332,21107,176,119.93,96225,82.01
2024-01-17,Z0104,110588,106238,100481,22273,192,116.01,78208,77.83
2024-01-17,Z0045,98519,95720,93406,26016,240,108.4,67390,72.15
2024-01-17,Z0105,101737,99603,94857,22691,258,87.95,72166,76.08
2024-01-17,Z0089,114486,110186,106666,15230,244,62.42,91436,85.72
2024-01-17,Z0069,95592,92868,87525,10983,162,67.8,76542,87.45
2024-01-17,Z0002,107270,103197,98392,31891,298,107.02,66501,67.59
2024-01-17,Z0046,123489,118907,115995,15509,197,78.73,100486,86.63
2024-01-17,Z0034,90870,89858,87361,14302,235,60.86,73059,83.63
2024-01-17,Z0025,124524,121239,118122,26923,263,102.37,91199,77.21
2024-01-17,Z0100,125596,123402,119755,15522,249,62.34,104233,87.04
2024-01-17,Z0091,103878,99982,94999,28842,248,116.3,66157,69.64
2024-01-17,Z0006,96771,95629,88309,19688,234,84.14,68621,77.71
2024-01-17,Z0062,121923,118162,112727,22007,232,94.86,90720,80.48
2024-01-17,Z0092,129390,127826,123395,20643,210,98.3,102752,83.27
2024-01-17,Z0059,91848,88493,83797,14538,168,86.54,69259,82.65
2024-01-17,Z0110,124485,122095,117023,15233,223,68.31,101790,86.98
2024-01-17,Z0068,99259,95473,87511,15914,169,94.17,71597,81.81
2024-01-17,Z0101,103409,98618,95330,27302,236,115.69,68028,71.36
2024-01-17,Z0018,126639,123833,120329,21313,259,82.29,99016,82.29
2024-01-17,Z0070,109692,105671,98559,16223,177,91.66,82336,83.54
2024-01-17,Z0065,117527,116456,112766,18337,208,88.16,94429,83.74
2024-01-17,Z0058,105549,103258,99914,35423,298,118.87,64491,64.55
2024-01-17,Z0067,120826,116523,111410,31376,281,111.66,80034,71.84
2024-01-17,Z0048,106061,104179,97945,10301,163,63.2,87644,89.48
2024-01-17,Z0031,112800,110296,105833,31671,288,109.97,74162,70.07
2024-01-17,Z0086,99940,95016,92593,22811,204,111.82,69782,75.36
2024-01-17,Z0052,118054,115463,108978,31338,269,116.5,77640,71.24
2024-01-17,Z0030,103233,101620,99128,16643,170,97.9,82485,83.21
2024-01-17,Z0080,90191,88693,81776,23942,236,101.45,57834,70.72
2024-01-17,Z0084,128599,126343,122375,23542,238,98.92,98833,80.76
2024-01-17,Z0032,110706,108312,104126,20741,299,69.37,83385,80.08
2024-01-17,Z0078,113383,111567,106347,23136,213,108.62,83211,78.24
2024-01-17,Z0005,113666,111193,108107,21097,292,72.25,87010,80.49
2024-01-17,Z0007,124642,122772,116009,26105,299,87.31,89904,77.5
2024-01-17,Z0012,100234,98962,95933,28294,242,116.92,67639,70.51
2024-01-17,Z0021,101410,98179,92110,30032,297,101.12,62078,67.4
2024-01-17,Z0039,91051,88478,83288,18837,268,70.29,64451,77.38
2024-01-17,Z0054,102580,98138,92341,14053,161,87.29,78288,84.78
2024-01-17,Z0047,101939,98834,91446,19884,169,117.66,71562,78.26
2024-01-17,Z0016,90307,85666,80307,27535,280,98.34,52772,65.71
2024-01-17,Z0014,119648,115472,112221,20102,239,84.11,92119,82.09
2024-01-17,Z0004,128134,124387,120870,20287,215,94.36,100583,83.22
2024-01-17,Z0015,96226,94017,90639,24785,215,115.28,65854,72.66
2024-01-17,Z0106,114423,111704,104813,18275,175,104.43,86538,82.56
2024-01-17,Z0056,94992,92031,85726,20894,257,81.3,64832,75.63
2024-01-17,Z0102,122551,118895,114401,30545,299,102.16,83856,73.3
2024-01-17,Z0013,103255,101784,95779,15201,178,85.4,80578,84.13
2024-01-17,Z0010,106567,101908,96550,26863,277,96.98,69687,72.18
2024-01-17,Z0094,112999,110601,105805,29721,293,101.44,76084,71.91
2024-01-17,Z0044,121521,118919,115646,14054,156,90.09,101592,87.85
2024-01-17,Z0066,117543,113986,108937,26797,237,113.07,82140,75.4
2024-01-17,Z0097,99497,97582,92501,26602,222,119.83,65899,71.24
2024-01-17,Z0087,121954,117048,110801,21174,186,113.84,89627,80.89
2024-01-17,Z0071,111698,108721,103367,26033,268,97.14,77334,74.81
2024-01-17,Z0112,100703,96519,94249,25998,244,106.55,68251,72.42
2024-01-17,Z0038,107570,106111,99911,20751,259,80.12,79160,79.23
2024-01-17,Z0085,122299,117946,110140,23941,202,118.52,86199,78.26
2024-01-17,Z0035,96305,92907,86378,18450,166,111.15,67928,78.64
2024-01-17,Z0090,129763,128624,121034,19041,243,78.36,101993,84.27
2024-01-17,Z0063,110566,107855,103625,17177,160,107.36,86448,83.42
2024-01-17,Z0095,96511,95383,92114,15983,220,72.65,76131,82.65
2024-01-17,Z0027,116177,114508,108538,16195,183,88.5,92343,85.08
2024-01-17,Z0023,113929,112781,105701,15145,199,76.11,90556,85.67
2024-01-17,Z0022,119523,117067,114440,18508,287,64.49,95932,83.83
2024-01-17,Z0096,101989,99497,95453,11289,164,68.84,84164,88.17
2024-01-17,Z0036,118128,116245,111904,33353,280,119.12,78551,70.19
2024-01-17,Z0041,128652,124438,122189,12638,189,66.87,109551,89.66
2024-01-17,Z0081,109309,107362,104388,14212,205,69.33,90176,86.39
2024-01-17,Z0082,115901,111805,108822,22919,288,79.58,85903,78.94
2024-01-17,Z0079,115464,111527,107410,20856,285,73.18,86554,80.58
2024-01-17,Z0033,125440,123566,120240,13894,205,67.78,106346,88.44
2024-01-17,Z0020,91987,90897,88368,15404,188,81.94,72964,82.57
2024-01-17,Z0064,102948,101210,96437,21413,274,78.15,75024,77.8
2024-01-17,Z0099,99878,98687,94701,13436,185,72.63,81265,85.81
2024-01-17,Z0075,100377,99033,96025,26764,235,113.89,69261,72.13
2024-01-17,Z0042,93783,90233,83935,18609,231,80.56,65326,77.83
2024-01-17,Z0057,94668,93477,89425,32899,276,119.2,56526,63.21
2024-01-17,Z0055,124484,123174,116636,17474,269,64.96,99162,85.02
2024-01-17,Z0049,124028,122159,116227,30623,279,109.76,85604,73.65
2024-01-17,Z0072,101460,99876,92186,15008,160,93.8,77178,83.72
2024-01-18,Z0017,120209,115689,113330,16993,245,69.36,96337,85.01
2024-01-18,Z0050,104011,100145,92247,14362,159,90.33,77885,84.43
2024-01-18,Z0060,108395,105240,98301,14927,248,60.19,83374,84.82
2024-01-18,Z0076,94006,91381,86617,18657,209,89.27,67960,78.46
2024-01-18,Z0003,120663,117681,110626,25431,294,86.5,85195,77.01
2024-01-18,Z0109,120140,116200,108643,21199,206,102.91,87444,80.49
2024-01-18,Z0001,93961,92356,87852,11287,158,71.44,76565,87.15
2024-01-18,Z0011,121417,118413,114694,22481,238,94.46,92213,80.4
2024-01-18,Z0108,119345,117075,113488,31550,264,119.51,81938,72.2
2024-01-18,Z0043,111031,108395,104237,32848,294,111.73,71389,68.49
2024-01-18,Z0026,108816,103912,97056,10282,164,62.7,86774,89.41
2024-01-18,Z0093,96837,94388,87888,19337,162,119.37,68551,78.0
2024-01-18,Z0024,95454,93222,87105,33298,286,116.43,53807,61.77
2024-01-18,Z0019,108412,106181,100423,20385,231,88.25,80038,79.7
2024-01-18,Z0088,127392,124355,119706,20022,225,88.99,99684,83.27
2024-01-18,Z0077,98848,97683,90739,14744,220,67.02,75995,83.75
2024-01-18,Z0040,90589,89161,84340,16628,197,84.41,67712,80.28
2024-01-18,Z0107,96509,91912,88650,16401,188,87.24,72249,81.5
2024-01-18,Z0008,99968,96506,93238,21617,238,90.83,71621,76.82
2024-01-18,Z0009,123783,120061,116978,32883,290,113.39,84095,71.89
2024-01-18,Z0111,118677,113897,106820,26618,283,94.06,80202,75.08
2024-01-18,Z0103,90406,86118,81042,26811,239,112.18,54231,66.92
2024-01-18,Z0061,107369,102766,96281,14979,203,73.79,81302,84.44
2024-01-18,Z0028,92618,90147,83298,21796,188,115.94,61502,73.83
2024-01-18,Z0029,112673,110262,102894,22532,226,99.7,80362,78.1
2024-01-18,Z0037,94621,92136,87186,19131,269,71.12,68055,78.06
2024-01-18,Z0074,104719,103164,98230,19871,280,70.97,78359,79.77
2024-01-18,Z0051,97566,96548,89878,28772,299,96.23,61106,67.99
2024-01-18,Z0098,114042,110244,107241,18181,221,82.27,89060,83.05
2024-01-18,Z0073,117042,112634,108168,12782,155,82.47,95386,88.18
2024-01-18,Z0083,116514,113575,109940,28849,248,116.33,81091,73.76
2024-01-18,Z0053,99890,94891,88364,21017,225,93.41,67347,76.22
2024-01-18,Z0104,100283,97388,89952,16990,180,94.39,72962,81.11
2024-01-18,Z0045,112908,111764,106366,15371,218,70.51,90995,85.55
2024-01-18,Z0105,127952,124550,117655,14639,238,61.51,103016,87.56
2024-01-18,Z0089,99343,95898,91942,13156,180,73.09,78786,85.69
2024-01-18,Z0069,129791,128329,120459,17470,233,74.98,102989,85.5
2024-01-18,Z0002,93907,92100,89914,31424,299,105.1,58490,65.05
2024-01-18,Z0046,94827,91892,84583,21774,194,112.24,62809,74.26
2024-01-18,Z0034,103699,102271,98964,16624,263,63.21,82340,83.2
2024-01-18,Z0025,95313,93003,86137,15897,230,69.12,70240,81.54
2024-01-18,Z0100,118807,117016,111162,22537,278,81.07,88625,79.73
2024-01-18,Z0091,104536,99978,96398,12888,166,77.64,83510,86.63
2024-01-18,Z0006,126343,124468,120050,25468,221,115.24,94582,78.79
2024-01-18,Z0062,126966,124965,117721,30103,258,116.68,87618,74.43
2024-01-18,Z0092,129887,126042,122561,16011,221,72.45,106550,86.94
2024-01-18,Z0059,117877,116220,108904,29772,260,114.51,79132,72.66
2024-01-18,Z0110,106244,102464,100042,15991,165,96.92,84051,84.02
2024-01-18,Z0068,113099,108418,102152,30058,294,102.24,72094,70.58
2024-01-18,Z0101,109094,107642,103245,17199,162,106.17,86046,83.34
2024-01-18,Z0018,91657,88116,83041,21515,243,88.54,61526,74.09
2024-01-18,Z0070,93164,89198,85145,17561,243,72.27,67584,79.38
2024-01-18,Z0065,128505,124288,118434,20155,204,98.8,98279,82.98
2024-01-18,Z0058,96009,94402,87850,26553,265,100.2,61297,69.77
2024-01-18,Z0067,99417,97182,94153,23150,257,90.08,71003,75.41
2024-01-18,Z0048,92671,89248,83286,17198,277,62.09,66088,79.35
2024-01-18,Z0031,102734,100900,95723,17775,206,86.29,77948,81.43
2024-01-18,Z0086,93722,91912,84392,18106,260,69.64,66286,78.55
2024-01-18,Z0052,103699,101741,98266,19474,224,86.94,78792,80.18
2024-01-18,Z0030,123576,121598,117135,12665,158,80.16,104470,89.19
2024-01-18,Z0080,122247,118746,113384,29905,289,103.48,83479,73.63
2024-01-18,Z0084,107600,104403,96404,21905,285,76.86,74499,77.28
2024-01-18,Z0032,109190,107412,104440,13329,161,82.79,91111,87.24
2024-01-18,Z0078,117386,113337,105703,15954,191,83.53,89749,84.91
2024-01-18,Z0005,103704,99317,95194,27103,288,94.11,68091,71.53
2024-01-18,Z0007,115174,110833,108609,25954,244,106.37,82655,76.1
2024-01-18,Z0012,104586,100282,97442,25763,234,110.1,71679,73.56
2024-01-18,Z0021,91814,90101,86995,17064,205,83.24,69931,80.39
2024-01-18,Z0039,106508,102262,95074,15348,251,61.15,79726,83.86
2024-01-18,Z0054,125699,123420,115574,13245,203,65.25,102329,88.54
2024-01-18,Z0047,102317,98989,94018,21307,264,80.71,72711,77.34
2024-01-18,Z0016,124785,120477,116062,15826,198,79.93,100236,86.36
2024-01-18,Z0014,119166,115070,111461,13247,212,62.49,98214,88.12
2024-01-18,Z0004,90717,86156,83140,19134,252,75.93,64006,76.99
2024-01-18,Z0015,118141,115804,109103,16467,166,99.2,92636,84.91
2024-01-18,Z0106,96782,93822,90774,19627,177,110.89,71147,78.38
2024-01-18,Z0056,115933,111507,109392,25722,268,95.98,83670,76.49
2024-01-18,Z0102,116671,111862,108061,17581,217,81.02,90480,83.73
2024-01-18,Z0013,100338,97856,90214,15434,192,80.39,74780,82.89
2024-01-18,Z0010,96548,92263,85483,9820,162,60.62,75663,88.51
2024-01-18,Z0094,117526,113976,108184,16756,181,92.58,91428,84.51
2024-01-18,Z0044,92941,90342,83437,18260,232,78.71,65177,78.12
2024-01-18,Z0066,115553,112452,107386,16997,248,68.54,90389,84.17
2024-01-18,Z0097,128218,126435,124195,13391,177,75.66,110804,89.22
2024-01-18,Z0087,98378,95497,88449,21683,197,110.07,66766,75.49
2024-01-18,Z0071,103675,102185,99755,30434,263,115.72,69321,69.49
2024-01-18,Z0112,112831,109486,107411,21278,286,74.4,86133,80.19
2024-01-18,Z0038,122443,120087,112210,17185,225,76.38,95025,84.68
2024-01-18,Z0085,129553,125008,118086,31645,268,118.08,86441,73.2
2024-01-18,Z0035,94686,91567,87665,19973,174,114.79,67692,77.22
2024-01-18,Z0090,102205,100631,93644,16156,216,74.8,77488,82.75
2024-01-18,Z0063,108443,107303,103514,26622,267,99.71,76892,74.28
2024-01-18,Z0095,118202,117186,110004,17298,175,98.85,92706,84.28
2024-01-18,Z0027,106848,105473,101646,23951,253,94.67,77695,76.44
2024-01-18,Z0023,115095,112235,110146,16774,216,77.66,93372,84.77
2024-01-18,Z0022,127583,123732,118889,11147,176,63.34,107742,90.62
2024-01-18,Z0096,119301,116417,110246,14389,164,87.74,95857,86.95
2024-01-18,Z0036,105972,104047,98313,25351,254,99.81,72962,74.21
2024-01-18,Z0041,112927,110122,107153,18030,175,103.03,89123,83.17
2024-01-18,Z0081,91094,88066,82871,19864,244,81.41,63007,76.03
2024-01-18,Z0082,124172,119808,113518,33104,289,114.55,80414,70.84
2024-01-18,Z0079,93982,92755,86742,18391,236,77.93,68351,78.8
2024-01-18,Z0033,114338,112878,106165,19914,261,76.3,86251,81.24
2024-01-18,Z0020,93092,92029,87955,24699,238,103.78,63256,71.92
2024-01-18,Z0064,113862,109803,107519,22548,280,80.53,84971,79.03
2024-01-18,Z0099,103971,100643,93710,25597,233,109.86,68113,72.68
2024-01-18,Z0075,94926,92739,86770,20479,265,77.28,66291,76.4
2024-01-18,Z0042,125733,124510,121727,34161,292,116.99,87566,71.94
2024-01-18,Z0057,129876,127927,121988,24801,259,95.76,97187,79.67
2024-01-18,Z0055,106428,103618,97052,19096,195,97.93,77956,80.32
2024-01-18,Z0049,108293,105025,97038,22520,270,83.41,74518,76.79
2024-01-18,Z0072,125349,123658,117639,24996,219,114.14,92643,78.75
2024-01-19,Z0017,120062,118131,111195,19071,261,73.07,92124,82.85
2024-01-19,Z0050,121730,118792,111123,27813,240,115.89,83310,74.97
2024-01-19,Z0060,121301,117114,111708,25153,253,99.42,86555,77.48
2024-01-19,Z0076,107695,106308,101187,15870,189,83.97,85317,84.32
2024-01-19,Z0003,108257,103669,100754,27741,238,116.56,73013,72.47
2024-01-19,Z0109,113165,108507,102759,22428,210,106.8,80331,78.17
2024-01-19,Z0001,123045,120068,116209,25639,271,94.61,90570,77.94
2024-01-19,Z0011,120497,116861,108932,16664,204,81.69,92268,84.7
2024-01-19,Z0108,129560,127943,120217,18292,251,72.88,101925,84.78
2024-01-19,Z0043,100374,98795,95625,25250,222,113.74,70375,73.59
2024-01-19,Z0026,102450,98962,95086,15753,151,104.33,79333,83.43
2024-01-19,Z0093,125230,122868,119238,19904,200,99.52,99334,83.31
2024-01-19,Z0024,90287,87430,81148,17013,257,66.2,64135,79.03
2024-01-19,Z0019,91161,90032,85669,25661,239,107.37,60008,70.05
2024-01-19,Z0088,114535,109679,101696,29898,274,109.12,71798,70.6
2024-01-19,Z0077,106527,105512,103268,29162,271,107.61,74106,71.76
2024-01-19,Z0040,93178,89019,84843,29781,252,118.18,55062,64.9
2024-01-19,Z0107,127770,125884,123544,11370,180,63.17,112174,90.8
2024-01-19,Z0008,116627,112229,104700,20569,225,91.42,84131,80.35
2024-01-19,Z0009,114881,112974,108320,12583,171,73.59,95737,88.38
2024-01-19,Z0111,101984,97688,91646,24562,260,94.47,67084,73.2
2024-01-19,Z0103,107755,103716,101396,31203,298,104.71,70193,69.23
2024-01-19,Z0061,127422,125218,117713,15157,171,88.64,102556,87.12
2024-01-19,Z0028,120313,115450,112319,10911,157,69.5,101408,90.29
2024-01-19,Z0029,100770,97313,91271,13228,166,79.69,78043,85.51
2024-01-19,Z0037,97498,93958,91947,16577,239,69.36,75370,81.97
2024-01-19,Z0074,92537,88695,84466,18745,230,81.5,65721,77.81
2024-01-19,Z0051,93009,88121,81370,14560,155,93.94,66810,82.11
2024-01-19,Z0098,104209,99822,95745,13506,163,82.86,82239,85.89
2024-01-19,Z0073,103907,99158,93291,31950,292,109.42,61341,65.75
2024-01-19,Z0083,94873,93430,91133,18812,176,106.89,72321,79.36
2024-01-19,Z0053,123783,121399,118002,14028,209,67.12,103974,88.11
2024-01-19,Z0104,119092,116823,113563,20913,207,101.03,92650,81.58
2024-01-19,Z0045,110947,107146,102736,20340,175,116.23,82396,80.2
2024-01-19,Z0105,119978,117402,110971,12673,169,74.99,98298,88.58
2024-01-19,Z0089,95543,91399,84716,20671,208,99.38,64045,75.6
2024-01-19,Z0069,115097,112210,107658,23579,295,79.93,84079,78.1
2024-01-19,Z0002,93809,91098,84215,18042,163,110.69,66173,78.58
2024-01-19,Z0046,97206,96147,89474,24157,284,85.06,65317,73.0
2024-01-19,Z0034,118992,116534,111055,24318,268,90.74,86737,78.1
2024-01-19,Z0025,103210,100801,97107,24657,212,116.31,72450,74.61
2024-01-19,Z0100,95197,90932,88406,22744,230,98.89,65662,74.27
2024-01-19,Z0091,104859,101199,97027,27632,297,93.04,69395,71.52
2024-01-19,Z0006,106663,102699,96722,29815,271,110.02,66907,69.17
2024-01-19,Z0062,109053,105160,97172,20032,253,79.18,77140,79.39
2024-01-19,Z0092,114209,111458,105477,22580,274,82.41,82897,78.59
2024-01-19,Z0059,111153,109002,104641,30141,256,117.74,74500,71.2
2024-01-19,Z0110,110811,108638,101065,20159,248,81.29,80906,80.05
2024-01-19,Z0068,103731,99638,94952,26651,290,91.9,68301,71.93
2024-01-19,Z0101,101087,98708,92173,27558,277,99.49,64615,70.1
2024-01-19,Z0018,92776,90657,85669,19058,261,73.02,66611,77.75
2024-01-19,Z0070,118835,117688,115494,20263,217,93.38,95231,82.46
2024-01-19,Z0065,107046,105567,99349,18315,293,62.51,81034,81.56
2024-01-19,Z0058,99615,95869,88809,16751,239,70.09,72058,81.14
2024-01-19,Z0067,100900,96725,88851,11833,180,65.74,77018,86.68
2024-01-19,Z0048,95581,90767,86753,25692,285,90.15,61061,70.38
2024-01-19,Z0031,110173,108464,104021,21376,194,110.19,82645,79.45
2024-01-19,Z0086,97148,92478,87265,25533,220,116.06,61732,70.74
2024-01-19,Z0052,108748,106014,100385,21853,264,82.78,78532,78.23
2024-01-19,Z0030,128687,124089,116414,26794,274,97.79,89620,76.98
2024-01-19,Z0080,115256,112923,106272,18820,179,105.14,87452,82.29
2024-01-19,Z0084,123377,118533,114377,18461,295,62.58,95916,83.86
2024-01-19,Z0032,126634,125263,122648,22798,266,85.71,99850,81.41
2024-01-19,Z0078,112394,109141,102199,18105,209,86.63,84094,82.28
2024-01-19,Z0005,90864,88596,81122,18917,275,68.79,62205,76.68
2024-01-19,Z0007,110955,109873,102644,22458,243,92.42,80186,78.12
2024-01-19,Z0012,106309,103072,97018,20116,271,74.23,76902,79.27
2024-01-19,Z0021,90935,85955,81617,21264,257,82.74,60353,73.95
2024-01-19,Z0039,106709,104175,98695,11635,155,75.07,87060,88.21
2024-01-19,Z0054,110245,107260,100328,22116,295,74.97,78212,77.96
2024-01-19,Z0047,127371,123593,120323,24620,271,90.85,95703,79.54
2024-01-19,Z0016,115216,110421,102447,12324,155,79.51,90123,87.97
2024-01-19,Z0014,97754,94796,88718,25448,272,93.56,63270,71.32
2024-01-19,Z0004,102853,100486,94444,15396,255,60.38,79048,83.7
2024-01-19,Z0015,104389,101636,97061,29929,294,101.8,67132,69.16
2024-01-19,Z0106,129522,124919,121338,23851,230,103.7,97487,80.34
2024-01-19,Z0056,124754,121514,115548,31423,282,111.43,84125,72.81
2024-01-19,Z0102,116681,112173,110045,21493,184,116.81,88552,80.47
2024-01-19,Z0013,128736,127031,121035,31993,299,107.0,89042,73.57
2024-01-19,Z0010,97493,96486,92410,13961,160,87.26,78449,84.89
2024-01-19,Z0094,92994,88250,80456,18218,152,119.86,62238,77.36
2024-01-19,Z0044,117332,114834,111190,22403,225,99.57,88787,79.85
2024-01-19,Z0066,125912,123210,115319,11225,167,67.22,104094,90.27
2024-01-19,Z0097,106626,101768,99598,15733,222,70.87,83865,84.2
2024-01-19,Z0087,129099,124587,117382,26269,232,113.23,91113,77.62
2024-01-19,Z0071,107883,104784,100626,17097,218,78.43,83529,83.01
2024-01-19,Z0112,100450,97415,92144,19077,179,106.58,73067,79.3
2024-01-19,Z0038,107241,102418,99369,22586,261,86.54,76783,77.27
2024-01-19,Z0085,123066,118918,115995,25395,223,113.88,90600,78.11
2024-01-19,Z0035,103331,99844,93538,16649,207,80.43,76889,82.2
2024-01-19,Z0090,109183,106609,99734,16836,276,61.0,82898,83.12
2024-01-19,Z0063,102254,98768,92723,15794,227,69.58,76929,82.97
2024-01-19,Z0095,100905,98840,92334,13746,197,69.78,78588,85.11
2024-01-19,Z0027,105882,102029,97372,18376,248,74.1,78996,81.13
2024-01-19,Z0023,119098,114752,111281,25763,234,110.1,85518,76.85
2024-01-19,Z0022,123709,120802,113965,19348,284,68.13,94617,83.02
2024-01-19,Z0096,114489,112246,104550,30827,275,112.1,73723,70.51
2024-01-19,Z0036,103543,102216,98750,13986,225,62.16,84764,85.84
2024-01-19,Z0041,120771,115814,111848,14782,203,72.82,97066,86.78
2024-01-19,Z0081,90375,89113,82751,15582,165,94.44,67169,81.17
2024-01-19,Z0082,112886,108498,103103,18617,167,111.48,84486,81.94
2024-01-19,Z0079,122651,117914,114021,27917,239,116.81,86104,75.52
2024-01-19,Z0033,120573,116874,111240,20256,257,78.82,90984,81.79
2024-01-19,Z0020,124420,121976,115835,20066,197,101.86,95769,82.68
2024-01-19,Z0064,123367,121648,117736,21237,226,93.97,96499,81.96
2024-01-19,Z0099,115868,114268,111888,17775,279,63.71,94113,84.11
2024-01-19,Z0075,110597,105960,101797,16536,176,93.96,85261,83.76
2024-01-19,Z0042,105989,104730,101632,25249,221,114.25,76383,75.16
2024-01-19,Z0057,128367,125015,122650,23605,260,90.79,99045,80.75
2024-01-19,Z0055,103945,100375,94956,13362,212,63.03,81594,85.93
2024-01-19,Z0049,120133,117109,112633,13625,161,84.63,99008,87.9
2024-01-19,Z0072,109953,105342,102596,20801,192,108.34,81795,79.73
2024-01-20,Z0017,121086,119774,113141,20325,269,75.56,92816,82.04
2024-01-20,Z0050,107304,105227,97641,18183,157,115.82,79458,81.38
2024-01-20,Z0060,97008,92773,87944,16095,185,87.0,71849,81.7
2024-01-20,Z0076,126386,124589,118146,23616,242,97.59,94530,80.01
2024-01-20,Z0003,123040,119030,112215,16252,250,65.01,95963,85.52
2024-01-20,Z0109,108157,103672,99125,23416,293,79.92,75709,76.38
2024-01-20,Z0001,125932,124248,117531,13877,220,63.08,103654,88.19
2024-01-20,Z0011,104327,100039,97093,28815,273,105.55,68278,70.32
2024-01-20,Z0108,104693,101028,98522,14250,178,80.06,84272,85.54
2024-01-20,Z0043,120254,116002,113759,12260,168,72.98,101499,89.22
2024-01-20,Z0026,115081,113660,108502,18416,170,108.33,90086,83.03
2024-01-20,Z0093,126358,122009,118137,20178,176,114.65,97959,82.92
2024-01-20,Z0024,118369,114313,111121,12273,178,68.95,98848,88.96
2024-01-20,Z0019,119001,117352,113888,17693,219,80.79,96195,84.46
2024-01-20,Z0088,90390,87871,81395,23578,279,84.51,57817,71.03
2024-01-20,Z0077,101569,99828,92913,11596,165,70.28,81317,87.52
2024-01-20,Z0040,125328,122557,119346,23677,249,95.09,95669,80.16
2024-01-20,Z0107,99121,96582,93670,17107,168,101.83,76563,81.74
2024-01-20,Z0008,107027,105601,103100,21689,290,74.79,81411,78.96
2024-01-20,Z0009,98921,96638,92520,20182,267,75.59,72338,78.19
2024-01-20,Z0111,120908,119618,113782,13721,171,80.24,100061,87.94
2024-01-20,Z0103,107303,103964,101209,20238,260,77.84,80971,80.0
2024-01-20,Z0061,95930,93624,85961,29271,296,98.89,56690,65.95
2024-01-20,Z0028,90507,88071,83496,26590,265,100.34,56906,68.15
2024-01-20,Z0029,101618,100060,94958,29815,297,100.39,65143,68.6
2024-01-20,Z0037,120979,119559,111911,18641,281,66.34,93270,83.34
2024-01-20,Z0074,127167,125226,119169,10684,154,69.38,108485,91.03
2024-01-20,Z0051,114495,110385,104670,25330,275,92.11,79340,75.8
2024-01-20,Z0098,97837,95536,88351,17147,171,100.28,71204,80.59
2024-01-20,Z0073,96411,93142,85219,12519,193,64.87,72700,85.31
2024-01-20,Z0083,120225,116064,113372,16553,191,86.67,96819,85.4
2024-01-20,Z0053,118926,116448,114192,29111,244,119.31,85081,74.51
2024-01-20,Z0104,100073,96427,89218,20761,296,70.14,68457,76.73
2024-01-20,Z0045,96533,94952,91217,29278,277,105.7,61939,67.9
2024-01-20,Z0105,101927,98282,96264,26200,234,111.97,70064,72.78
2024-01-20,Z0089,99316,94331,89677,27633,232,119.11,62044,69.19
2024-01-20,Z0069,97933,95553,87892,17585,181,97.16,70307,79.99
2024-01-20,Z0002,92080,89087,85540,22999,265,86.79,62541,73.11
2024-01-20,Z0046,97797,95936,93782,20883,209,99.92,72899,77.73
2024-01-20,Z0034,109878,107974,104705,27202,245,111.03,77503,74.02
2024-01-20,Z0025,116140,113956,111210,11974,195,61.41,99236,89.23
2024-01-20,Z0100,124493,120305,118035,19645,256,76.74,98390,83.36
2024-01-20,Z0091,112195,109685,103729,26890,288,93.37,76839,74.08
2024-01-20,Z0006,106555,105282,100976,14717,153,96.19,86259,85.43
2024-01-20,Z0062,116347,114926,107386,28366,260,109.1,79020,73.59
2024-01-20,Z0092,115785,112374,105699,21535,244,88.26,84164,79.63
2024-01-20,Z0059,103009,98742,91766,17279,241,71.7,74487,81.17
2024-01-20,Z0110,119793,116141,112668,14233,196,72.62,98435,87.37
2024-01-20,Z0068,109627,108245,104064,27409,255,107.49,76655,73.66
2024-01-20,Z0101,116025,111929,106673,28542,255,111.93,78131,73.24
2024-01-20,Z0018,99782,96996,90757,16360,257,63.66,74397,81.97
2024-01-20,Z0070,112366,107385,99587,12398,189,65.6,87189,87.55
2024-01-20,Z0065,99627,98404,96185,24821,224,110.81,71364,74.19
2024-01-20,Z0058,102466,99812,93284,11126,161,69.11,82158,88.07
2024-01-20,Z0067,127292,122559,117785,16834,176,95.65,100951,85.71
2024-01-20,Z0048,120916,118339,113215,19988,198,100.95,93227,82.35
2024-01-20,Z0031,101706,99353,94031,12556,209,60.08,81475,86.65
2024-01-20,Z0086,102070,100181,94327,17838,233,76.56,76489,81.09
2024-01-20,Z0052,90924,87754,83852,10631,174,61.1,73221,87.32
2024-01-20,Z0030,95506,93144,86271,16144,159,101.54,70127,81.29
2024-01-20,Z0080,125163,124135,122101,15012,189,79.43,107089,87.71
2024-01-20,Z0084,101781,99362,94692,25179,254,99.13,69513,73.41
2024-01-20,Z0032,126133,124545,119327,12465,196,63.6,106862,89.55
2024-01-20,Z0078,109522,107619,101533,11511,171,67.32,90022,88.66
2024-01-20,Z0005,98531,97357,93643,17103,256,66.81,76540,81.74
2024-01-20,Z0007,119122,117566,110311,18429,229,80.48,91882,83.29
2024-01-20,Z0012,101279,98923,93657,27543,238,115.73,66114,70.59
2024-01-20,Z0021,96477,92073,89057,19518,222,87.92,69539,78.08
2024-01-20,Z0039,96470,93408,90570,10319,159,64.9,80251,88.61
2024-01-20,Z0054,109880,107067,101588,15034,169,88.96,86554,85.2
2024-01-20,Z0047,104308,101857,97544,18399,215,85.58,79145,81.14
2024-01-20,Z0016,99706,97475,93830,28244,273,103.46,65586,69.9
2024-01-20,Z0014,128599,124600,119160,27852,279,99.83,91308,76.63
2024-01-20,Z0004,126824,125519,119983,19038,227,83.87,100945,84.13
2024-01-20,Z0015,116299,113610,110093,18600,164,113.42,91493,83.11
2024-01-20,Z0106,120063,115146,112727,21864,233,93.84,90863,80.6
2024-01-20,Z0056,92936,88074,81845,14146,173,81.77,67699,82.72
2024-01-20,Z0102,104318,100306,96856,16936,259,65.39,79920,82.51
2024-01-20,Z0013,117672,115119,109858,19956,295,67.65,89902,81.83
2024-01-20,Z0010,117281,112895,107380,30963,277,111.78,76417,71.17
2024-01-20,Z0094,128328,124165,119939,20511,299,68.6,99428,82.9
2024-01-20,Z0044,91079,88901,81110,22105,185,119.49,59005,72.75
2024-01-20,Z0066,110590,107406,100843,15651,171,91.53,85192,84.48
2024-01-20,Z0097,97235,95422,88054,27402,229,119.66,60652,68.88
2024-01-20,Z0087,111473,108442,106120,24642,245,100.58,81478,76.78
2024-01-20,Z0071,104287,101472,95969,34677,297,116.76,61292,63.87
2024-01-20,Z0112,122230,118577,114101,19690,258,76.32,94411,82.74
2024-01-20,Z0038,93340,88560,82317,29209,298,98.02,53108,64.52
2024-01-20,Z0085,91141,89292,86926,22949,289,79.41,63977,73.6
2024-01-20,Z0035,109281,107192,101151,22040,236,93.39,79111,78.21
2024-01-20,Z0090,124806,120946,114676,13273,195,68.07,101403,88.43
2024-01-20,Z0063,94683,93189,85956,22283,193,115.46,63673,74.08
2024-01-20,Z0095,124552,120042,114256,23365,203,115.1,90891,79.55
2024-01-20,Z0027,111650,110616,107618,19537,247,79.1,88081,81.85
2024-01-20,Z0023,128196,124611,117478,14805,176,84.12,102673,87.4
2024-01-20,Z0022,104892,102441,98690,19556,253,77.3,79134,80.18
2024-01-20,Z0096,111042,107056,102122,25871,228,113.47,76251,74.67
2024-01-20,Z0036,96869,92135,86789,14284,180,79.36,72505,83.54
2024-01-20,Z0041,110918,106115,98136,15982,232,68.89,82154,83.71
2024-01-20,Z0081,115274,112962,108000,20103,181,111.07,87897,81.39
2024-01-20,Z0082,103851,99913,93126,20963,184,113.93,72163,77.49
2024-01-20,Z0079,95296,91188,83458,11587,178,65.1,71871,86.12
2024-01-20,Z0033,103921,102795,95193,20203,244,82.8,74990,78.78
2024-01-20,Z0020,107575,103936,97547,18163,218,83.32,79384,81.38
2024-01-20,Z0064,105997,103631,100612,19846,238,83.39,80766,80.27
2024-01-20,Z0099,112837,109128,103049,21934,278,78.9,81115,78.71
2024-01-20,Z0075,110923,109239,103610,15306,236,64.86,88304,85.23
2024-01-20,Z0042,92887,89604,86142,17589,203,86.65,68553,79.58
2024-01-20,Z0057,126854,123593,117413,22821,203,112.42,94592,80.56
2024-01-20,Z0055,92841,90074,83894,28143,248,113.48,55751,66.45
2024-01-20,Z0049,96040,91480,87368,21975,276,79.62,65393,74.85
2024-01-20,Z0072,120341,118679,116053,20566,260,79.1,95487,82.28
2024-01-21,Z0017,121658,116712,109698,23516,233,100.93,86182,78.56
2024-01-21,Z0050,91375,89194,81486,18099,178,101.68,63387,77.79
2024-01-21,Z0060,90490,85761,77787,29206,280,104.31,48581,62.45
2024-01-21,Z0076,109680,106740,100332,26113,257,101.61,74219,73.97
2024-01-21,Z0003,121334,119416,115534,19453,258,75.4,96081,83.16
2024-01-21,Z0109,111292,107305,99720,13090,153,85.56,86630,86.87
2024-01-21,Z0001,93159,88205,80783,17440,168,103.81,63343,78.41
2024-01-21,Z0011,119351,117917,115236,29121,290,100.42,86115,74.73
2024-01-21,Z0108,111638,109565,102014,18435,235,78.45,83579,81.93
2024-01-21,Z0043,108771,105377,100684,25227,260,97.03,75457,74.94
2024-01-21,Z0026,119320,118076,113920,17378,235,73.95,96542,84.75
2024-01-21,Z0093,106184,101314,96734,17459,191,91.41,79275,81.95
2024-01-21,Z0024,118967,115808,108100,23419,264,88.71,84681,78.34
2024-01-21,Z0019,101440,98050,92319,14720,192,76.67,77599,84.06
2024-01-21,Z0088,102021,98345,94718,18635,286,65.16,76083,80.33
2024-01-21,Z0077,98219,94235,90250,22283,188,118.53,67967,75.31
2024-01-21,Z0040,120232,119175,115654,15723,160,98.27,99931,86.41
2024-01-21,Z0107,98488,95307,89905,9998,160,62.49,79907,88.88
2024-01-21,Z0008,129932,126335,123434,17028,168,101.36,106406,86.2
2024-01-21,Z0009,112444,110346,106669,20794,265,78.47,85875,80.51
2024-01-21,Z0111,92881,90690,83824,25384,214,118.62,58440,69.72
2024-01-21,Z0103,95622,90666,87288,20992,221,94.99,66296,75.95
2024-01-21,Z0061,107632,102897,95247,30336,267,113.62,64911,68.15
2024-01-21,Z0028,97036,93645,85777,15359,156,98.46,70418,82.09
2024-01-21,Z0029,112499,111347,106871,25155,210,119.79,81716,76.46
2024-01-21,Z0037,94603,90406,83820,29506,289,102.1,54314,64.8
2024-01-21,Z0074,109937,108593,104832,20782,259,80.24,84050,80.18
2024-01-21,Z0051,90220,87282,80464,22936,200,114.68,57528,71.5
2024-01-21,Z0098,97349,94827,89939,20268,195,103.94,69671,77.46
2024-01-21,Z0073,127344,123367,119496,31997,270,118.51,87499,73.22
2024-01-21,Z0083,114299,110380,106918,27983,274,102.13,78935,73.83
2024-01-21,Z0053,105905,104561,102517,26643,265,100.54,75874,74.01
2024-01-21,Z0104,124836,122179,114196,25948,224,115.84,88248,77.28
2024-01-21,Z0045,96191,93677,89079,13611,156,87.25,75468,84.72
2024-01-21,Z0105,104622,102621,99588,13152,160,82.2,86436,86.79
2024-01-21,Z0089,113283,112010,104959,13601,172,79.08,91358,87.04
2024-01-21,Z0069,117223,114444,107968,20992,260,80.74,86976,80.56
2024-01-21,Z0002,120024,118546,116031,17864,203,88.0,98167,84.6
2024-01-21,Z0046,91191,86599,81931,22228,246,90.36,59703,72.87
2024-01-21,Z0034,96297,93886,88606,14453,227,63.67,74153,83.69
2024-01-21,Z0025,98334,93652,86464,28886,241,119.86,57578,66.59
2024-01-21,Z0100,120966,116634,113847,27191,242,112.36,86656,76.12
2024-01-21,Z0091,128990,126309,123687,29267,259,113.0,94420,76.34
2024-01-21,Z0006,110225,105549,100977,20893,251,83.24,80084,79.31
2024-01-21,Z0062,129683,127746,122486,19010,196,96.99,103476,84.48
2024-01-21,Z0092,111598,109982,102855,23178,213,108.82,79677,77.47
2024-01-21,Z0059,90066,85499,79213,15433,156,98.93,63780,80.52
2024-01-21,Z0110,97533,93718,87102,19766,223,88.64,67336,77.31
2024-01-21,Z0068,128498,124966,119386,25991,284,91.52,93395,78.23
2024-01-21,Z0101,113849,108869,105682,16733,199,84.09,88949,84.17
2024-01-21,Z0018,102940,98601,96053,15645,201,77.84,80408,83.71
2024-01-21,Z0070,119769,115190,109103,15921,153,104.06,93182,85.41
2024-01-21,Z0065,114648,111293,109095,14250,153,93.14,94845,86.94
2024-01-21,Z0058,117777,114996,112425,12326,184,66.99,100099,89.04
2024-01-21,Z0067,107174,104536,100705,17097,185,92.42,83608,83.02
2024-01-21,Z0048,103798,98874,95700,27390,272,100.7,68310,71.38
2024-01-21,Z0031,90178,86934,80848,20720,181,114.48,60128,74.37
2024-01-21,Z0086,107118,103982,101184,20747,295,70.33,80437,79.5
2024-01-21,Z0052,97601,95814,91019,15427,165,93.5,75592,83.05
2024-01-21,Z0030,121926,120718,114130,17233,180,95.74,96897,84.9
2024-01-21,Z0080,97297,93585,88501,15175,166,91.42,73326,82.85
2024-01-21,Z0084,120329,116411,113680,16948,188,90.15,96732,85.09
2024-01-21,Z0032,91129,86683,83078,11600,179,64.81,71478,86.04
2024-01-21,Z0078,101970,98225,93055,21029,215,97.81,72026,77.4
2024-01-21,Z0005,119265,114607,109674,19796,185,107.01,89878,81.95
2024-01-21,Z0007,105187,102972,100648,11908,150,79.39,88740,88.17
2024-01-21,Z0012,95074,92325,88475,28264,239,118.26,60211,68.05
2024-01-21,Z0021,129867,127377,124484,29239,283,103.32,95245,76.51
2024-01-21,Z0039,124158,119769,113530,20719,235,88.17,92811,81.75
2024-01-21,Z0054,110863,107600,102168,27977,295,94.84,74191,72.62
2024-01-21,Z0047,125139,121053,114741,15157,250,60.63,99584,86.79
2024-01-21,Z0016,91515,87517,79931,12548,182,68.95,67383,84.3
2024-01-21,Z0014,125685,123050,118698,18841,161,117.03,99857,84.13
2024-01-21,Z0004,122728,120561,118451,32154,286,112.43,86297,72.85
2024-01-21,Z0015,111493,110262,102452,24493,225,108.86,77959,76.09
2024-01-21,Z0106,110039,105246,101491,22979,266,86.39,78512,77.36
2024-01-21,Z0056,122335,117764,114187,17819,266,66.99,96368,84.39
2024-01-21,Z0102,118350,115130,112158,16026,167,95.97,96132,85.71
2024-01-21,Z0013,123798,119572,114979,16165,257,62.9,98814,85.94
2024-01-21,Z0010,96691,91699,85086,23433,271,86.47,61653,72.46
2024-01-21,Z0094,107297,104035,99854,25916,272,95.28,73938,74.05
2024-01-21,Z0044,109581,106637,103175,23635,262,90.21,79540,77.09
2024-01-21,Z0066,105511,102133,96679,12498,171,73.09,84181,87.07
2024-01-21,Z0097,105474,101533,95980,27017,276,97.89,68963,71.85
2024-01-21,Z0087,103386,101197,93889,15089,174,86.72,78800,83.93
2024-01-21,Z0071,96221,92227,89540,19854,234,84.85,69686,77.83
2024-01-21,Z0112,111045,108838,104944,32810,293,111.98,72134,68.74
2024-01-21,Z0038,94922,92571,88760,23771,268,88.7,64989,73.22
2024-01-21,Z0085,122479,117682,110504,19010,299,63.58,91494,82.8
2024-01-21,Z0035,120022,116070,112426,14707,191,77.0,97719,86.92
2024-01-21,Z0090,126736,123020,120830,20645,223,92.58,100185,82.91
2024-01-21,Z0063,107719,106012,100906,17563,271,64.81,83343,82.59
2024-01-21,Z0095,110213,106929,104314,18985,272,69.8,85329,81.8
2024-01-21,Z0027,90463,86162,83196,24253,232,104.54,58943,70.85
2024-01-21,Z0023,110651,106493,100869,14809,178,83.2,86060,85.32
2024-01-21,Z0022,94938,92617,89928,12882,155,83.11,77046,85.68
2024-01-21,Z0096,95603,92391,84573,16960,187,90.7,67613,79.95
2024-01-21,Z0036,106766,103510,97700,33450,296,113.01,64250,65.76
2024-01-21,Z0041,101695,99283,95700,17324,157,110.35,78376,81.9
2024-01-21,Z0081,104559,101509,99138,20613,233,88.47,78525,79.21
2024-01-21,Z0082,128333,126723,124608,14402,234,61.55,110206,88.44
2024-01-21,Z0079,123214,120823,115499,26912,285,94.43,88587,76.7
2024-01-21,Z0033,119086,114920,107016,27045,226,119.67,79971,74.73
2024-01-21,Z0020,128737,126664,119851,14768,158,93.47,105083,87.68
2024-01-21,Z0064,95454,91304,87699,15099,226,66.81,72600,82.78
2024-01-21,Z0099,105386,102068,95411,14493,220,65.88,80918,84.81
2024-01-21,Z0075,114327,109665,103183,27444,251,109.34,75739,73.4
2024-01-21,Z0042,111181,107575,100507,15814,171,92.48,84693,84.27
2024-01-21,Z0057,128248,123311,120328,11972,150,79.82,108356,90.05
2024-01-21,Z0055,111991,110640,106916,22600,259,87.26,84316,78.86
2024-01-21,Z0049,100143,97864,93957,16933,262,64.63,77024,81.98
2024-01-21,Z0072,119424,115596,112572,19165,161,119.04,93407,82.98
2024-01-22,Z0017,126942,124683,120302,26316,261,100.83,93986,78.13
2024-01-22,Z0050,115464,111044,107939,17158,270,63.55,90781,84.1
2024-01-22,Z0060,117125,114135,106539,28599,283,101.06,77940,73.16
2024-01-22,Z0076,106374,101376,95601,11927,174,68.55,83674,87.52
2024-01-22,Z0003,117388,115468,108823,18986,290,65.47,89837,82.55
2024-01-22,Z0109,108445,107054,99578,11435,177,64.61,88143,88.52
2024-01-22,Z0001,105960,101321,96156,21248,212,100.23,74908,77.9
2024-01-22,Z0011,127203,123559,116707,17353,205,84.65,99354,85.13
2024-01-22,Z0108,104626,100070,95389,22053,260,84.82,73336,76.88
2024-01-22,Z0043,125967,122295,119357,15324,217,70.62,104033,87.16
2024-01-22,Z0026,113824,111977,109536,25503,216,118.07,84033,76.72
2024-01-22,Z0093,126993,122790,120194,16076,155,103.72,104118,86.62
2024-01-22,Z0024,96054,93549,90688,21729,243,89.42,68959,76.04
2024-01-22,Z0019,100832,98834,93103,10972,174,63.06,82131,88.22
2024-01-22,Z0088,91551,87685,79949,24913,231,107.85,55036,68.84
2024-01-22,Z0077,117812,115301,111565,20480,215,95.26,91085,81.64
2024-01-22,Z0040,129620,127171,119218,17170,194,88.51,102048,85.6
2024-01-22,Z0107,114426,110767,106046,22662,212,106.9,83384,78.63
2024-01-22,Z0008,99637,96339,91414,25684,263,97.66,65730,71.9
2024-01-22,Z0009,99824,96247,91873,35386,296,119.55,56487,61.48
2024-01-22,Z0111,113488,111594,109082,20450,202,101.24,88632,81.25
2024-01-22,Z0103,90215,86012,80681,17903,163,109.84,62778,77.81
2024-01-22,Z0061,100364,96211,92505,20876,200,104.38,71629,77.43
2024-01-22,Z0028,124335,121127,116796,13448,168,80.05,103348,88.49
2024-01-22,Z0029,100345,98217,92707,25037,241,103.89,67670,72.99
2024-01-22,Z0037,118899,114128,108475,20012,182,109.96,88463,81.55
2024-01-22,Z0074,95583,93782,86064,17429,272,64.08,68635,79.75
2024-01-22,Z0051,96001,92080,85513,17484,275,63.58,68029,79.55
2024-01-22,Z0098,99271,95599,90088,16963,248,68.4,73125,81.17
2024-01-22,Z0073,103329,99588,94568,23025,229,100.55,71543,75.65
2024-01-22,Z0083,96256,95028,92858,25074,275,91.18,67784,73.0
2024-01-22,Z0053,106678,105490,103065,12900,203,63.55,90165,87.48
2024-01-22,Z0104,113185,111267,106014,17793,177,100.53,88221,83.22
2024-01-22,Z0045,123266,120445,115636,11828,195,60.66,103808,89.77
2024-01-22,Z0105,127729,125904,120125,20133,234,86.04,99992,83.24
2024-01-22,Z0089,124886,121591,119446,27960,234,119.49,91486,76.59
2024-01-22,Z0069,103929,99083,91668,17389,214,81.26,74279,81.03
2024-01-22,Z0002,127333,122756,120564,26439,264,100.15,94125,78.07
2024-01-22,Z0046,129405,124517,122466,21785,256,85.1,100681,82.21
2024-01-22,Z0034,121601,118191,114371,21612,226,95.63,92759,81.1
2024-01-22,Z0025,125289,122420,117852,17612,236,74.63,100240,85.06
2024-01-22,Z0100,128650,126196,122329,26313,298,88.3,96016,78.49
2024-01-22,Z0091,97465,92959,88221,22612,240,94.22,65609,74.37
2024-01-22,Z0006,109583,106004,98474,24775,237,104.54,73699,74.84
2024-01-22,Z0062,102197,100358,98118,30334,284,106.81,67784,69.08
2024-01-22,Z0092,94631,92224,86722,23756,233,101.96,62966,72.61
2024-01-22,Z0059,114658,112677,106909,24408,240,101.7,82501,77.17
2024-01-22,Z0110,97995,96385,89716,21862,258,84.74,67854,75.63
2024-01-22,Z0068,112813,110825,105220,17697,170,104.1,87523,83.18
2024-01-22,Z0101,102746,98463,94290,17703,261,67.83,76587,81.22
2024-01-22,Z0018,118060,115538,110937,18653,236,79.04,92284,83.19
2024-01-22,Z0070,109041,106057,98395,16933,266,63.66,81462,82.79
2024-01-22,Z0065,92159,88710,82880,16075,177,90.82,66805,80.6
2024-01-22,Z0058,94368,92051,85558,13770,174,79.14,71788,83.91
2024-01-22,Z0067,117094,115110,111880,17056,190,89.77,94824,84.76
2024-01-22,Z0048,107517,103006,99705,12244,187,65.48,87461,87.72
2024-01-22,Z0031,118610,113971,110061,21300,224,95.09,88761,80.65
2024-01-22,Z0086,114466,110850,107345,10709,152,70.46,96636,90.02
2024-01-22,Z0052,114354,110169,106253,15785,248,63.65,90468,85.14
2024-01-22,Z0030,119491,115591,110043,16386,168,97.54,93657,85.11
2024-01-22,Z0080,125525,122569,120391,22376,265,84.44,98015,81.41
2024-01-22,Z0084,98683,93721,91661,20937,184,113.79,70724,77.16
2024-01-22,Z0032,99269,96566,91671,26023,275,94.63,65648,71.61
2024-01-22,Z0078,105323,104259,98576,18792,238,78.96,79784,80.94
2024-01-22,Z0005,128591,125373,119413,32116,296,108.5,87297,73.11
2024-01-22,Z0007,101962,100428,94966,18268,174,104.99,76698,80.76
2024-01-22,Z0012,94011,90271,84873,20941,222,94.33,63932,75.33
2024-01-22,Z0021,92155,89285,86281,20684,296,69.88,65597,76.03
2024-01-22,Z0039,111709,108072,100937,16469,229,71.92,84468,83.68
2024-01-22,Z0054,125474,124473,121440,23122,295,78.38,98318,80.96
2024-01-22,Z0047,114700,112596,107897,26205,274,95.64,81692,75.71
2024-01-22,Z0016,124629,122456,117536,14550,170,85.59,102986,87.62
2024-01-22,Z0014,98320,96883,90037,26923,245,109.89,63114,70.1
2024-01-22,Z0004,100740,96611,93390,19435,188,103.38,73955,79.19
2024-01-22,Z0015,120930,115945,113044,14481,159,91.08,98563,87.19
2024-01-22,Z0106,104380,100212,92814,12859,167,77.0,79955,86.15
2024-01-22,Z0056,95529,92021,85535,29786,274,108.71,55749,65.18
2024-01-22,Z0102,126686,124619,122593,13653,164,83.25,108940,88.86
2024-01-22,Z0013,96937,92769,90222,12407,158,78.53,77815,86.25
2024-01-22,Z0010,100860,99294,96591,21344,281,75.96,75247,77.9
2024-01-22,Z0094,128106,126922,121782,20215,292,69.23,101567,83.4
2024-01-22,Z0044,104201,99521,92578,20586,201,102.42,71992,77.76
2024-01-22,Z0066,98997,94295,88504,14457,154,93.88,74047,83.67
2024-01-22,Z0097,93225,88607,84481,33379,295,113.15,51102,60.49
2024-01-22,Z0087,125228,123683,115955,28047,242,115.9,87908,75.81
2024-01-22,Z0071,113110,109548,105469,26628,258,103.21,78841,74.75
2024-01-22,Z0112,93114,90188,87572,16587,244,67.98,70985,81.06
2024-01-22,Z0038,110028,106711,103508,13597,216,62.95,89911,86.86
2024-01-22,Z0085,125333,121159,116078,16428,259,63.43,99650,85.85
2024-01-22,Z0035,125398,121237,114916,15975,266,60.06,98941,86.1
2024-01-22,Z0090,120435,118519,113351,21306,191,111.55,92045,81.2
2024-01-22,Z0063,100313,95615,88305,22859,269,84.98,65446,74.11
2024-01-22,Z0095,110462,107757,99819,13827,186,74.34,85992,86.15
2024-01-22,Z0027,104271,99484,93333,23443,222,105.6,69890,74.88
2024-01-22,Z0023,108984,105905,100307,28131,279,100.83,72176,71.96
2024-01-22,Z0022,102861,101195,98912,15169,209,72.58,83743,84.66
2024-01-22,Z0096,95840,90937,85372,20455,189,108.23,64917,76.04
2024-01-22,Z0036,110977,108512,106383,27160,234,116.07,79223,74.47
2024-01-22,Z0041,111118,106755,102695,16448,238,69.11,86247,83.98
2024-01-22,Z0081,105630,100958,96464,14130,169,83.61,82334,85.35
2024-01-22,Z0082,90992,87230,83109,32896,279,117.91,50213,60.42
2024-01-22,Z0079,117160,116060,111837,25609,271,94.5,86228,77.1
2024-01-22,Z0033,110906,106718,101481,26410,255,103.57,75071,73.98
2024-01-22,Z0020,94136,92708,90365,21241,248,85.65,69124,76.49
2024-01-22,Z0064,122167,120802,114098,21039,267,78.8,93059,81.56
2024-01-22,Z0099,121376,119649,115373,16116,218,73.93,99257,86.03
2024-01-22,Z0075,94920,90719,83248,12565,208,60.41,70683,84.91
2024-01-22,Z0042,107272,104229,100888,19778,275,71.92,81110,80.4
2024-01-22,Z0057,129895,125175,120292,31854,293,108.72,88438,73.52
2024-01-22,Z0055,105696,103400,97188,20881,254,82.21,76307,78.51
2024-01-22,Z0049,113345,109930,106813,20381,184,110.77,86432,80.92
2024-01-22,Z0072,109385,106647,103283,24720,251,98.49,78563,76.07
2024-01-23,Z0017,92708,87723,80933,14382,179,80.35,66551,82.23
2024-01-23,Z0050,107308,106157,103572,26126,293,89.17,77446,74.78
2024-01-23,Z0060,125089,122512,120017,14351,221,64.94,105666,88.04
2024-01-23,Z0076,92148,90592,83391,24853,229,108.53,58538,70.2
2024-01-23,Z0003,91552,88432,83347,17717,191,92.76,65630,78.74
2024-01-23,Z0109,122924,121190,113667,17383,156,111.43,96284,84.71
2024-01-23,Z0001,98055,96497,91221,13984,183,76.42,77237,84.67
2024-01-23,Z0011,122922,118068,115072,15720,155,101.42,99352,86.34
2024-01-23,Z0108,116870,115340,110435,28568,283,100.95,81867,74.13
2024-01-23,Z0043,104259,100674,93850,23036,230,100.16,70814,75.45
2024-01-23,Z0026,90153,85396,79209,20301,224,90.63,58908,74.37
2024-01-23,Z0093,105792,102407,94808,20687,264,78.36,74121,78.18
2024-01-23,Z0024,108100,103898,99041,19140,177,108.14,79901,80.67
2024-01-23,Z0019,90786,89514,83242,19685,227,86.72,63557,76.35
2024-01-23,Z0088,117454,115812,107818,17163,170,100.96,90655,84.08
2024-01-23,Z0077,113600,112034,109369,26487,252,105.11,82882,75.78
2024-01-23,Z0040,109810,105027,97600,24813,221,112.28,72787,74.58
2024-01-23,Z0107,129779,124823,119122,20561,261,78.78,98561,82.74
2024-01-23,Z0008,99261,95912,89409,22503,208,108.19,66906,74.83
2024-01-23,Z0009,123980,120111,112162,26393,258,102.3,85769,76.47
2024-01-23,Z0111,99344,95736,88499,20256,205,98.81,68243,77.11
2024-01-23,Z0103,108895,107752,103263,20677,184,112.38,82586,79.98
2024-01-23,Z0061,97367,93139,86557,28229,253,111.58,58328,67.39
2024-01-23,Z0028,103147,98942,92699,13279,150,88.53,79420,85.68
2024-01-23,Z0029,103647,99505,94201,16543,236,70.1,77658,82.44
2024-01-23,Z0037,109097,108008,104651,22534,224,100.6,82117,78.47
2024-01-23,Z0074,107107,104509,99499,21882,212,103.22,77617,78.01
2024-01-23,Z0051,95555,94488,88652,24461,276,88.63,64191,72.41
2024-01-23,Z0098,124305,122908,116193,33521,282,118.87,82672,71.15
2024-01-23,Z0073,101549,98965,95802,15589,152,102.56,80213,83.73
2024-01-23,Z0083,111209,109654,103993,27361,248,110.33,76632,73.69
2024-01-23,Z0053,116327,112386,107729,26575,261,101.82,81154,75.33
2024-01-23,Z0104,116905,113197,106106,27513,244,112.76,78593,74.07
2024-01-23,Z0045,107985,104192,100712,11824,173,68.35,88888,88.26
2024-01-23,Z0105,112614,110512,105236,19512,231,84.47,85724,81.46
2024-01-23,Z0089,105613,102262,94763,14649,228,64.25,80114,84.54
2024-01-23,Z0069,129041,125398,122099,17732,176,100.75,104367,85.48
2024-01-23,Z0002,129469,127571,120269,13686,185,73.98,106583,88.62
2024-01-23,Z0046,105627,100748,97213,17084,228,74.93,80129,82.43
2024-01-23,Z0034,122355,121278,116447,21914,196,111.81,94533,81.18
2024-01-23,Z0025,101819,99287,97050,26312,247,106.53,70738,72.89
2024-01-23,Z0100,111637,108641,101330,23265,245,94.96,78065,77.04
2024-01-23,Z0091,93089,91566,85291,24554,265,92.66,60737,71.21
2024-01-23,Z0006,120429,115985,110863,9505,150,63.37,101358,91.43
2024-01-23,Z0062,95190,93711,89914,18566,228,81.43,71348,79.35
2024-01-23,Z0092,124899,120673,117858,18981,270,70.3,98877,83.9
2024-01-23,Z0059,129434,128292,122005,19967,231,86.44,102038,83.63
2024-01-23,Z0110,124178,122801,120267,11928,187,63.79,108339,90.08
2024-01-23,Z0068,116292,111928,108896,18000,240,75.0,90896,83.47
2024-01-23,Z0101,126110,123700,116427,24947,250,99.79,91480,78.57
2024-01-23,Z0018,127268,123381,120209,18819,205,91.8,101390,84.34
2024-01-23,Z0070,117914,116493,112852,19881,233,85.33,92971,82.38
2024-01-23,Z0065,109324,107778,101052,12267,171,71.74,88785,87.86
2024-01-23,Z0058,114054,112017,107192,18346,165,111.19,88846,82.88
2024-01-23,Z0067,110107,107278,104915,23583,277,85.14,81332,77.52
2024-01-23,Z0048,100358,96049,93504,12717,166,76.61,80787,86.4
2024-01-23,Z0031,93240,89671,82942,32322,279,115.85,50620,61.03
2024-01-23,Z0086,91936,89256,86294,23269,243,95.76,63025,73.04
2024-01-23,Z0052,101998,100116,94276,16476,218,75.58,77800,82.52
2024-01-23,Z0030,129691,127821,121210,13625,165,82.58,107585,88.76
2024-01-23,Z0080,120825,118717,112408,12902,215,60.01,99506,88.52
2024-01-23,Z0084,93203,89306,85062,22604,249,90.78,62458,73.43
2024-01-23,Z0032,122786,121145,116062,18695,171,109.33,97367,83.89
2024-01-23,Z0078,111584,110255,107390,29155,259,112.57,78235,72.85
2024-01-23,Z0005,123541,122150,115418,25460,220,115.73,89958,77.94
2024-01-23,Z0007,117518,113819,106698,25173,246,102.33,81525,76.41
2024-01-23,Z0012,92567,87734,84060,25497,281,90.74,58563,69.67
2024-01-23,Z0021,100875,96495,93756,14871,231,64.38,78885,84.14
2024-01-23,Z0039,91545,90077,85818,20234,208,97.28,65584,76.42
2024-01-23,Z0054,99327,97296,94423,13110,177,74.07,81313,86.12
2024-01-23,Z0047,100492,97943,95192,14559,219,66.48,80633,84.71
2024-01-23,Z0016,103749,100972,98119,11571,183,63.23,86548,88.21
2024-01-23,Z0014,110116,106833,103504,19499,255,76.47,84005,81.16
2024-01-23,Z0004,98669,94943,89852,21879,262,83.51,67973,75.65
2024-01-23,Z0015,120935,117033,110803,14550,167,87.13,96253,86.87
2024-01-23,Z0106,121624,119472,112967,22702,262,86.65,90265,79.9
2024-01-23,Z0056,111797,109528,101853,20473,188,108.9,81380,79.9
2024-01-23,Z0102,102373,98770,90809,24256,228,106.39,66553,73.29
2024-01-23,Z0013,105734,103265,100888,19095,179,106.68,81793,81.07
2024-01-23,Z0010,108064,105990,103749,12887,207,62.26,90862,87.58
2024-01-23,Z0094,99111,96525,89158,19577,220,88.99,69581,78.04
2024-01-23,Z0044,106453,101529,94028,23906,255,93.75,70122,74.58
2024-01-23,Z0066,124775,122975,115838,16407,219,74.92,99431,85.84
2024-01-23,Z0097,114503,110724,103804,25938,217,119.53,77866,75.01
2024-01-23,Z0087,90755,87356,83361,22467,201,111.78,60894,73.05
2024-01-23,Z0071,107400,103149,95284,18223,178,102.38,77061,80.88
2024-01-23,Z0112,114600,112758,107920,25317,227,111.53,82603,76.54
2024-01-23,Z0038,123505,120401,118222,26379,225,117.24,91843,77.69
2024-01-23,Z0085,119148,116326,111703,31647,277,114.25,80056,71.67
2024-01-23,Z0035,98646,96391,90007,17341,221,78.47,72666,80.73
2024-01-23,Z0090,112785,111256,106980,19390,262,74.01,87590,81.88
2024-01-23,Z0063,113777,112182,106308,19880,232,85.69,86428,81.3
2024-01-23,Z0095,110914,109033,101156,17773,209,85.04,83383,82.43
2024-01-23,Z0027,127265,123596,119461,15451,179,86.32,104010,87.07
2024-01-23,Z0023,96727,91763,88198,24634,275,89.58,63564,72.07
2024-01-23,Z0022,122427,121119,118777,12684,191,66.41,106093,89.32
2024-01-23,Z0096,105577,101342,94062,14464,180,80.36,79598,84.62
2024-01-23,Z0036,123710,122186,116307,22968,295,77.86,93339,80.25
2024-01-23,Z0041,106195,102082,97120,13094,166,78.88,84026,86.52
2024-01-23,Z0081,129121,127381,120424,29772,259,114.95,90652,75.28
2024-01-23,Z0082,122018,120065,116763,15789,205,77.02,100974,86.48
2024-01-23,Z0079,112223,108343,104156,13231,206,64.23,90925,87.3
2024-01-23,Z0033,111271,109726,101786,19439,184,105.65,82347,80.9
2024-01-23,Z0020,103304,100377,92728,30379,278,109.28,62349,67.24
2024-01-23,Z0064,110536,107377,105373,25108,214,117.33,80265,76.17
2024-01-23,Z0099,101673,99236,93983,18968,170,111.58,75015,79.82
2024-01-23,Z0075,105372,103010,99190,30257,272,111.24,68933,69.5
2024-01-23,Z0042,92663,88725,85452,15874,175,90.71,69578,81.42
2024-01-23,Z0057,93326,88667,83722,23580,214,110.19,60142,71.84
2024-01-23,Z0055,117594,115463,108700,18123,166,109.18,90577,83.33
2024-01-23,Z0049,113121,109485,104456,20442,172,118.85,84014,80.43
2024-01-23,Z0072,101211,98930,91838,19848,220,90.22,71990,78.39
2024-01-24,Z0017,96022,94741,89582,22844,195,117.15,66738,74.5
2024-01-24,Z0050,103515,100452,93421,19687,227,86.73,73734,78.93
2024-01-24,Z0060,111691,110363,105772,24860,245,101.47,80912,76.5
2024-01-24,Z0076,93044,90624,82988,11393,159,71.66,71595,86.27
2024-01-24,Z0003,101593,96702,91810,20746,230,90.2,71064,77.4
2024-01-24,Z0109,111672,108956,101659,21742,219,99.28,79917,78.61
2024-01-24,Z0001,90654,88269,85510,25077,254,98.73,60433,70.67
2024-01-24,Z0011,91798,89735,84764,13506,207,65.25,71258,84.07
2024-01-24,Z0108,119087,114661,112407,21602,295,73.23,90805,80.78
2024-01-24,Z0043,111646,106823,102947,15347,246,62.39,87600,85.09
2024-01-24,Z0026,117200,115301,109180,21487,284,75.66,87693,80.32
2024-01-24,Z0093,110900,106166,102922,14280,176,81.14,88642,86.13
2024-01-24,Z0024,112356,108813,101457,13088,185,70.75,88369,87.1
2024-01-24,Z0019,129148,127140,120826,14926,218,68.47,105900,87.65
2024-01-24,Z0088,116535,113027,106269,22389,204,109.75,83880,78.93
2024-01-24,Z0077,125450,121235,118246,27223,229,118.88,91023,76.98
2024-01-24,Z0040,102476,101222,95059,23760,268,88.66,71299,75.0
2024-01-24,Z0107,94711,91328,84359,17969,184,97.66,66390,78.7
2024-01-24,Z0008,122152,118805,111084,23128,236,98.0,87956,79.18
2024-01-24,Z0009,110836,109581,106574,28604,246,116.28,77970,73.16
2024-01-24,Z0111,116331,111739,107168,24915,220,113.25,82253,76.75
2024-01-24,Z0103,93908,89911,85108,18423,181,101.79,66685,78.35
2024-01-24,Z0061,101957,100674,95291,12314,192,64.14,82977,87.08
2024-01-24,Z0028,106482,105286,100757,14056,150,93.71,86701,86.05
2024-01-24,Z0029,90877,86580,82712,12610,155,81.36,70102,84.75
2024-01-24,Z0037,121334,117669,114281,24087,220,109.49,90194,78.92
2024-01-24,Z0074,92637,88491,85426,24713,298,82.93,60713,71.07
2024-01-24,Z0051,125651,123447,120903,17662,246,71.8,103241,85.39
2024-01-24,Z0098,118742,114103,110880,19714,200,98.57,91166,82.22
2024-01-24,Z0073,109556,107789,102132,19513,205,95.19,82619,80.89
2024-01-24,Z0083,129288,127634,123188,14796,181,81.75,108392,87.99
2024-01-24,Z0053,98412,93746,87469,12788,177,72.25,74681,85.38
2024-01-24,Z0104,110786,107217,99702,23070,279,82.69,76632,76.86
2024-01-24,Z0045,116627,112717,106732,29724,263,113.02,77008,72.15
2024-01-24,Z0105,119475,115123,108813,11801,164,71.96,97012,89.15
2024-01-24,Z0089,109403,104722,101279,11002,171,64.34,90277,89.14
2024-01-24,Z0069,117586,112994,110422,23084,223,103.52,87338,79.09
2024-01-24,Z0002,127521,123535,117533,22133,266,83.21,95400,81.17
2024-01-24,Z0046,95629,91495,83743,16312,237,68.83,67431,80.52
2024-01-24,Z0034,102278,101053,94853,24920,269,92.64,69933,73.73
2024-01-24,Z0025,124765,122994,116470,12434,206,60.36,104036,89.32
2024-01-24,Z0100,115009,112779,107680,20177,270,74.73,87503,81.26
2024-01-24,Z0091,126175,122540,117400,23043,286,80.57,94357,80.37
2024-01-24,Z0006,109177,104593,99682,11570,166,69.7,88112,88.39
2024-01-24,Z0062,108799,107549,100598,24766,261,94.89,75832,75.38
2024-01-24,Z0092,118333,116140,109484,21715,234,92.8,87769,80.17
2024-01-24,Z0059,95565,92224,89306,20531,223,92.07,68775,77.01
2024-01-24,Z0110,123941,119738,117306,17322,167,103.73,99984,85.23
2024-01-24,Z0068,90835,87589,83327,23990,250,95.96,59337,71.21
2024-01-24,Z0101,101824,100353,94538,13665,166,82.32,80873,85.55
2024-01-24,Z0018,92429,90439,85129,32910,281,117.12,52219,61.34
2024-01-24,Z0070,92607,90533,82603,28212,297,94.99,54391,65.85
2024-01-24,Z0065,122353,117554,110770,22118,196,112.85,88652,80.03
2024-01-24,Z0058,121099,117578,112427,12456,158,78.84,99971,88.92
2024-01-24,Z0067,121416,116978,109398,11970,164,72.99,97428,89.06
2024-01-24,Z0048,97054,92444,85389,10958,168,65.23,74431,87.17
2024-01-24,Z0031,127341,123290,117799,14950,175,85.43,102849,87.31
2024-01-24,Z0086,90706,86421,79188,23485,241,97.45,55703,70.34
2024-01-24,Z0052,128523,124659,122072,22708,280,81.1,99364,81.4
2024-01-24,Z0030,107718,105226,101379,17803,191,93.21,83576,82.44
2024-01-24,Z0080,129619,124685,118759,24459,225,108.71,94300,79.4
2024-01-24,Z0084,93317,89162,82860,21944,212,103.51,60916,73.52
2024-01-24,Z0032,129828,126830,121773,21960,198,110.91,99813,81.97
2024-01-24,Z0078,116660,115328,112926,29549,248,119.15,83377,73.83
2024-01-24,Z0005,98605,97561,91404,28998,249,116.46,62406,68.27
2024-01-24,Z0007,117043,115176,107589,12534,156,80.35,95055,88.35
2024-01-24,Z0012,105155,104137,101773,26969,249,108.31,74804,73.5
2024-01-24,Z0021,113851,109773,103941,16991,203,83.7,86950,83.65
2024-01-24,Z0039,96571,94431,91852,12117,198,61.2,79735,86.81
2024-01-24,Z0054,104017,100645,94495,26814,267,100.43,67681,71.62
2024-01-24,Z0047,109423,108382,100966,23413,241,97.15,77553,76.81
2024-01-24,Z0016,118902,117450,111489,21143,297,71.19,90346,81.04
2024-01-24,Z0014,103833,101452,97985,21051,227,92.74,76934,78.52
2024-01-24,Z0004,103439,99701,96485,22893,239,95.79,73592,76.27
2024-01-24,Z0015,107264,102450,97301,10781,175,61.61,86520,88.92
2024-01-24,Z0106,114660,112607,106463,14070,212,66.37,92393,86.78
2024-01-24,Z0056,91168,90100,84971,22331,217,102.91,62640,73.72
2024-01-24,Z0102,105032,100387,95861,12930,151,85.63,82931,86.51
2024-01-24,Z0013,93516,89149,81352,13958,179,77.98,67394,82.84
2024-01-24,Z0010,120270,117076,111521,17783,193,92.14,93738,84.05
2024-01-24,Z0094,104157,102142,99697,17054,227,75.13,82643,82.89
2024-01-24,Z0044,129132,124506,118490,24700,247,100.0,93790,79.15
2024-01-24,Z0066,126643,124242,118905,21563,298,72.36,97342,81.87
2024-01-24,Z0097,106645,103797,96805,13185,215,61.33,83620,86.38
2024-01-24,Z0087,103382,100116,92464,17591,236,74.54,74873,80.98
2024-01-24,Z0071,94175,91328,86019,14320,172,83.26,71699,83.35
2024-01-24,Z0112,99174,94731,87720,18328,197,93.04,69392,79.11
2024-01-24,Z0038,100725,99032,92912,25960,233,111.42,66952,72.06
2024-01-24,Z0085,121351,118539,110890,18723,195,96.02,92167,83.12
2024-01-24,Z0035,104254,101521,94345,16430,161,102.05,77915,82.59
2024-01-24,Z0090,95724,94706,91299,21189,249,85.1,70110,76.79
2024-01-24,Z0063,98032,95816,92406,18676,232,80.5,73730,79.79
2024-01-24,Z0095,109881,108605,101765,25424,283,89.84,76341,75.02
2024-01-24,Z0027,115752,114114,107782,16722,249,67.16,91060,84.49
2024-01-24,Z0023,123765,120663,113108,17795,161,110.53,95313,84.27
2024-01-24,Z0022,117307,114151,108214,22242,266,83.62,85972,79.45
2024-01-24,Z0096,114502,112111,104794,20532,220,93.33,84262,80.41
2024-01-24,Z0036,128258,126886,119270,13507,168,80.4,105763,88.68
2024-01-24,Z0041,105958,102710,99862,13188,202,65.29,86674,86.79
2024-01-24,Z0081,100748,98403,94081,16029,197,81.37,78052,82.96
2024-01-24,Z0082,112738,111235,106046,15458,218,70.91,90588,85.42
2024-01-24,Z0079,120761,119447,115071,19580,280,69.93,95491,82.98
2024-01-24,Z0033,115616,114334,109344,18462,172,107.34,90882,83.12
2024-01-24,Z0020,114833,113259,106590,15502,158,98.12,91088,85.46
2024-01-24,Z0064,121331,119289,115737,18679,242,77.19,97058,83.86
2024-01-24,Z0099,121556,120134,112549,31254,298,104.88,81295,72.23
2024-01-24,Z0075,111876,110119,105309,25266,270,93.58,80043,76.01
2024-01-24,Z0042,114518,112414,104744,25574,221,115.72,79170,75.58
2024-01-24,Z0057,114099,110628,104104,23596,274,86.12,80508,77.33
2024-01-24,Z0055,128885,123893,121690,12371,163,75.9,109319,89.83
2024-01-24,Z0049,109159,105827,101835,18413,159,115.81,83422,81.92
2024-01-24,Z0072,126877,124017,120056,16848,257,65.56,103208,85.97
2024-01-25,Z0017,111560,109838,107059,11560,183,63.17,95499,89.2
2024-01-25,Z0050,98720,96923,94580,17907,271,66.08,76673,81.07
2024-01-25,Z0060,118362,113680,106282,23480,264,88.94,82802,77.91
2024-01-25,Z0076,111120,106714,103403,24199,252,96.03,79204,76.6
2024-01-25,Z0003,117912,114594,110647,29710,290,102.45,80937,73.15
2024-01-25,Z0109,124812,123394,119645,22705,234,97.03,96940,81.02
2024-01-25,Z0001,126160,122388,117908,26683,281,94.96,91225,77.37
2024-01-25,Z0011,104444,100756,97211,19380,168,115.36,77831,80.06
2024-01-25,Z0108,91070,87644,83794,23752,230,103.27,60042,71.65
2024-01-25,Z0043,92939,89038,81773,11085,155,71.52,70688,86.44
2024-01-25,Z0026,106301,101302,93451,17846,200,89.23,75605,80.9
2024-01-25,Z0093,106378,104700,101712,20680,276,74.93,81032,79.67
2024-01-25,Z0024,119777,116302,112695,13849,151,91.72,98846,87.71
2024-01-25,Z0019,117445,114943,111154,19635,288,68.18,91519,82.34
2024-01-25,Z0088,111665,106755,99728,17297,159,108.79,82431,82.66
2024-01-25,Z0077,105867,103806,99366,18570,261,71.15,80796,81.31
2024-01-25,Z0040,121213,116942,113664,21973,255,86.17,91691,80.67
2024-01-25,Z0107,103490,99896,93207,18151,163,111.36,75056,80.53
2024-01-25,Z0008,128285,123482,119277,21970,235,93.49,97307,81.58
2024-01-25,Z0009,99219,96005,90466,12771,199,64.18,77695,85.88
2024-01-25,Z0111,119631,116175,110692,19495,169,115.36,91197,82.39
2024-01-25,Z0103,108625,105343,100578,21944,284,77.27,78634,78.18
2024-01-25,Z0061,101422,97072,90161,11631,187,62.2,78530,87.1
2024-01-25,Z0028,123171,121279,116554,15239,193,78.96,101315,86.93
2024-01-25,Z0029,126931,122397,120310,25696,223,115.23,94614,78.64
2024-01-25,Z0037,120936,117888,114730,17067,271,62.98,97663,85.12
2024-01-25,Z0074,112200,109826,102087,20888,200,104.44,81199,79.54
2024-01-25,Z0051,117433,115052,108049,13024,200,65.12,95025,87.95
2024-01-25,Z0098,121169,119584,112499,27141,298,91.08,85358,75.87
2024-01-25,Z0073,103419,100250,96186,17989,234,76.88,78197,81.3
2024-01-25,Z0083,128083,124709,122392,16733,188,89.01,105659,86.33
2024-01-25,Z0053,121528,119026,114984,10769,167,64.49,104215,90.63
2024-01-25,Z0104,94598,91576,89458,18006,206,87.41,71452,79.87
2024-01-25,Z0045,123477,118908,113351,13169,197,66.85,100182,88.38
2024-01-25,Z0105,118716,117403,112153,20134,223,90.29,92019,82.05
2024-01-25,Z0089,98061,96644,92041,21515,181,118.87,70526,76.62
2024-01-25,Z0069,107485,106160,100732,11684,174,67.15,89048,88.4
2024-01-25,Z0002,98177,95738,91477,13010,206,63.16,78467,85.78
2024-01-25,Z0046,114405,113332,107698,22816,275,82.97,84882,78.81
2024-01-25,Z0034,103890,102382,98003,11287,180,62.71,86716,88.48
2024-01-25,Z0025,99484,97085,91180,20136,182,110.64,71044,77.92
2024-01-25,Z0100,101267,97058,89410,11027,167,66.03,78383,87.67
2024-01-25,Z0091,127939,123222,120898,20257,233,86.94,100641,83.24
2024-01-25,Z0006,116569,111593,104781,21242,263,80.77,83539,79.73
2024-01-25,Z0062,118948,115365,109808,23585,295,79.95,86223,78.52
2024-01-25,Z0092,93587,92436,89482,22996,237,97.03,66486,74.3
2024-01-25,Z0059,113544,111676,108485,14679,179,82.01,93806,86.47
2024-01-25,Z0110,123455,122146,118644,24179,287,84.25,94465,79.62
2024-01-25,Z0068,93127,89460,82892,32287,288,112.11,50605,61.05
2024-01-25,Z0101,101559,98051,92656,16532,162,102.05,76124,82.16
2024-01-25,Z0018,115389,113544,110380,24063,217,110.89,86317,78.2
2024-01-25,Z0070,128672,126229,122462,21607,243,88.92,100855,82.36
2024-01-25,Z0065,123122,120250,116226,13056,172,75.91,103170,88.77
2024-01-25,Z0058,125585,120753,114478,14068,214,65.74,100410,87.71
2024-01-25,Z0067,103107,100736,94470,11596,183,63.37,82874,87.73
2024-01-25,Z0048,118666,115145,110564,20038,285,70.31,90526,81.88
2024-01-25,Z0031,99582,97452,92966,25217,261,96.62,67749,72.88
2024-01-25,Z0086,98418,93903,87366,12804,162,79.04,74562,85.34
2024-01-25,Z0052,108827,107100,99400,16890,152,111.12,82510,83.01
2024-01-25,Z0030,104419,99733,94111,17990,272,66.14,76121,80.88
2024-01-25,Z0080,123804,120972,113028,25733,225,114.37,87295,77.23
2024-01-25,Z0084,97435,94887,91744,30279,257,117.82,61465,67.0
2024-01-25,Z0032,95065,91665,85708,25230,226,111.64,60478,70.56
2024-01-25,Z0078,93407,91768,89596,9155,151,60.63,80441,89.78
2024-01-25,Z0005,95666,94408,88449,32929,284,115.95,55520,62.77
2024-01-25,Z0007,115092,111315,108793,19137,237,80.75,89656,82.41
2024-01-25,Z0012,100109,96223,92059,18732,222,84.38,73327,79.65
2024-01-25,Z0021,116505,111560,104325,28686,290,98.92,75639,72.5
2024-01-25,Z0039,97746,92963,88373,23002,223,103.15,65371,73.97
2024-01-25,Z0054,105596,103758,97682,20352,259,78.58,77330,79.17
2024-01-25,Z0047,127953,125860,119980,22587,255,88.58,97393,81.17
2024-01-25,Z0016,92785,89816,85058,16476,156,105.62,68582,80.63
2024-01-25,Z0014,93990,91876,85031,19358,248,78.06,65673,77.23
2024-01-25,Z0004,109073,105812,101937,19276,234,82.38,82661,81.09
2024-01-25,Z0015,109790,107003,101071,20667,281,73.55,80404,79.55
2024-01-25,Z0106,116183,111435,109387,20413,175,116.65,88974,81.34
2024-01-25,Z0056,128176,123315,115570,20617,234,88.11,94953,82.16
2024-01-25,Z0102,113790,110610,105564,19641,272,72.21,85923,81.39
2024-01-25,Z0013,92833,90644,87247,23939,217,110.32,63308,72.56
2024-01-25,Z0010,104116,99567,93741,15972,202,79.07,77769,82.96
2024-01-25,Z0094,119150,117319,112622,16742,193,86.75,95880,85.13
2024-01-25,Z0044,120286,118605,113870,19527,250,78.11,94343,82.85
2024-01-25,Z0066,114662,111390,107327,16039,246,65.2,91288,85.06
2024-01-25,Z0097,107205,102776,100614,13552,161,84.18,87062,86.53
2024-01-25,Z0087,97777,93038,88641,19429,177,109.77,69212,78.08
2024-01-25,Z0071,108316,104588,99053,18445,259,71.22,80608,81.38
2024-01-25,Z0112,120522,117662,112216,29352,252,116.48,82864,73.84
2024-01-25,Z0038,103403,100175,95385,28391,261,108.78,66994,70.24
2024-01-25,Z0085,109091,104228,96250,26048,224,116.29,70202,72.94
2024-01-25,Z0035,126701,122316,119394,21203,217,97.71,98191,82.24
2024-01-25,Z0090,100367,95777,88232,22451,220,102.05,65781,74.55
2024-01-25,Z0063,123332,119074,114477,28940,250,115.76,85537,74.72
2024-01-25,Z0095,125268,123798,120811,13814,223,61.95,106997,88.57
2024-01-25,Z0027,129649,125013,122790,30458,292,104.31,92332,75.2
2024-01-25,Z0023,129065,125458,123108,12928,154,83.95,110180,89.5
2024-01-25,Z0022,108312,103665,101317,14441,200,72.21,86876,85.75
2024-01-25,Z0096,118853,117217,114200,17611,153,115.11,96589,84.58
2024-01-25,Z0036,108610,104500,97633,23600,229,103.06,74033,75.83
2024-01-25,Z0041,97170,95155,89031,14669,174,84.31,74362,83.52
2024-01-25,Z0081,125187,120593,116700,26703,247,108.11,89997,77.12
2024-01-25,Z0082,103753,101527,96487,17722,158,112.17,78765,81.63
2024-01-25,Z0079,107509,103392,97231,30812,295,104.45,66419,68.31
2024-01-25,Z0033,94042,91908,85475,21034,212,99.22,64441,75.39
2024-01-25,Z0020,116746,114018,111572,24277,254,95.58,87295,78.24
2024-01-25,Z0064,125426,121064,116346,23350,242,96.49,92996,79.93
2024-01-25,Z0099,125712,124432,121837,13044,177,73.7,108793,89.29
2024-01-25,Z0075,91986,88236,85162,16609,225,73.82,68553,80.5
2024-01-25,Z0042,102161,100952,94731,21849,247,88.46,72882,76.94
2024-01-25,Z0057,119163,114583,109576,19916,245,81.29,89660,81.82
2024-01-25,Z0055,123737,122157,117333,30599,261,117.24,86734,73.92
2024-01-25,Z0049,91211,89982,83698,22515,237,95.0,61183,73.1
2024-01-25,Z0072,104345,100160,97659,22912,239,95.87,74747,76.54
2024-01-26,Z0017,116708,115660,110094,20147,187,107.74,89947,81.7
2024-01-26,Z0050,105173,101118,98430,28681,281,102.07,69749,70.86
2024-01-26,Z0060,123737,119277,116272,19590,217,90.28,96682,83.15
2024-01-26,Z0076,95820,92816,87764,32375,279,116.04,55389,63.11
2024-01-26,Z0003,113781,110479,106196,17132,275,62.3,89064,83.87
2024-01-26,Z0109,105620,102831,96465,30872,260,118.74,65593,68.0
2024-01-26,Z0001,122890,119187,115907,18174,200,90.87,97733,84.32
2024-01-26,Z0011,93727,91283,89025,22271,273,81.58,66754,74.98
2024-01-26,Z0108,115523,112429,105471,26790,260,103.04,78681,74.6
2024-01-26,Z0043,90524,88637,86430,15384,176,87.41,71046,82.2
2024-01-26,Z0026,117370,116222,113785,17027,262,64.99,96758,85.04
2024-01-26,Z0093,93749,89588,81771,17507,273,64.13,64264,78.59
2024-01-26,Z0024,118477,117120,111875,12611,204,61.82,99264,88.73
2024-01-26,Z0019,128104,125174,118623,27435,244,112.44,91188,76.87
2024-01-26,Z0088,92823,90191,83467,16404,236,69.51,67063,80.35
2024-01-26,Z0077,105167,103682,101483,14744,233,63.28,86739,85.47
2024-01-26,Z0040,102658,100645,96663,14975,165,90.76,81688,84.51
2024-01-26,Z0107,113380,110909,104566,25919,294,88.16,78647,75.21
2024-01-26,Z0008,92311,88182,82809,22385,226,99.05,60424,72.97
2024-01-26,Z0009,103560,101956,96108,13882,194,71.56,82226,85.56
2024-01-26,Z0111,128553,126136,118220,19156,211,90.79,99064,83.8
2024-01-26,Z0103,110981,106318,100443,23798,201,118.4,76645,76.31
2024-01-26,Z0061,113916,109983,107435,14214,193,73.65,93221,86.77
2024-01-26,Z0028,93815,89651,86804,21269,266,79.96,65535,75.5
2024-01-26,Z0029,127477,126066,119293,19989,183,109.23,99304,83.24
2024-01-26,Z0037,102446,99385,92917,24335,204,119.29,68582,73.81
2024-01-26,Z0074,100464,95888,88696,15232,191,79.75,73464,82.83
2024-01-26,Z0051,93320,89762,83064,23745,271,87.62,59319,71.41
2024-01-26,Z0098,116572,111899,108335,20358,251,81.11,87977,81.21
2024-01-26,Z0073,128826,124791,119500,17453,277,63.01,102047,85.39
2024-01-26,Z0083,90726,88482,83022,19231,285,67.48,63791,76.84
2024-01-26,Z0053,96697,91979,88914,20150,262,76.91,68764,77.34
2024-01-26,Z0104,102963,99043,96761,24792,234,105.95,71969,74.38
2024-01-26,Z0045,91081,86196,81315,12139,198,61.31,69176,85.07
2024-01-26,Z0105,100776,96632,91662,13335,218,61.17,78327,85.45
2024-01-26,Z0089,105958,102069,96572,18580,211,88.06,77992,80.76
2024-01-26,Z0069,107331,105667,101950,16197,189,85.7,85753,84.11
2024-01-26,Z0002,103436,102370,99734,16413,212,77.42,83321,83.54
2024-01-26,Z0046,123332,120731,117906,12065,199,60.63,105841,89.77
2024-01-26,Z0034,103393,98723,95698,21921,227,96.57,73777,77.09
2024-01-26,Z0025,92251,90590,87786,17688,192,92.13,70098,79.85
2024-01-26,Z0100,117027,112853,106222,20338,271,75.05,85884,80.85
2024-01-26,Z0091,99583,97348,91316,27633,244,113.25,63683,69.74
2024-01-26,Z0006,128784,125620,118897,29776,278,107.11,89121,74.96
2024-01-26,Z0062,103036,98487,92287,19842,170,116.72,72445,78.5
2024-01-26,Z0092,97938,96893,93539,26957,229,117.72,66582,71.18
2024-01-26,Z0059,95335,93354,86299,23100,265,87.17,63199,73.23
2024-01-26,Z0110,95611,92775,87883,20450,174,117.53,67433,76.73
2024-01-26,Z0068,95577,90959,87400,23760,269,88.33,63640,72.81
2024-01-26,Z0101,129451,126944,120873,15808,206,76.74,105065,86.92
2024-01-26,Z0018,124831,120189,116189,28403,277,102.54,87786,75.55
2024-01-26,Z0070,120962,117989,110982,30587,280,109.24,80395,72.44
2024-01-26,Z0065,91294,87486,81421,13092,189,69.27,68329,83.92
2024-01-26,Z0058,117328,112410,108657,22485,276,81.47,86172,79.31
2024-01-26,Z0067,107706,104846,100405,13149,204,64.46,87256,86.9
2024-01-26,Z0048,107482,105505,102000,28942,258,112.18,73058,71.63
2024-01-26,Z0031,99318,98022,92973,30453,261,116.68,62520,67.25
2024-01-26,Z0086,105574,101560,94402,19937,264,75.52,74465,78.88
2024-01-26,Z0052,118930,114143,110047,25405,236,107.65,84642,76.91
2024-01-26,Z0030,101801,98593,90605,24995,215,116.26,65610,72.41
2024-01-26,Z0080,106559,101897,94801,26755,284,94.21,68046,71.78
2024-01-26,Z0084,112398,108896,102897,22469,191,117.64,80428,78.16
2024-01-26,Z0032,108051,106776,102231,18132,169,107.29,84099,82.26
2024-01-26,Z0078,115251,112428,105281,13280,176,75.46,92001,87.39
2024-01-26,Z0005,109643,106540,103994,21475,212,101.3,82519,79.35
2024-01-26,Z0007,127999,123130,119047,17470,168,103.99,101577,85.33
2024-01-26,Z0012,124808,123370,119618,31215,266,117.35,88403,73.9
2024-01-26,Z0021,91849,88207,84607,25980,230,112.96,58627,69.29
2024-01-26,Z0039,110786,106181,100382,33340,281,118.65,67042,66.79
2024-01-26,Z0054,91132,88737,81262,13107,178,73.64,68155,83.87
2024-01-26,Z0047,128563,125448,121109,13246,200,66.23,107863,89.06
2024-01-26,Z0016,100931,99751,96264,19818,218,90.91,76446,79.41
2024-01-26,Z0014,127777,125220,121107,20616,206,100.08,100491,82.98
2024-01-26,Z0004,91044,88409,83978,18444,166,111.11,65534,78.04
2024-01-26,Z0015,114363,111725,108143,15083,248,60.82,93060,86.05
2024-01-26,Z0106,104374,102066,95149,22467,278,80.82,72682,76.39
2024-01-26,Z0056,98793,96173,89293,16891,158,106.91,72402,81.08
2024-01-26,Z0102,119883,118213,110851,14171,176,80.52,96680,87.22
2024-01-26,Z0013,127960,124434,122334,23024,225,102.33,99310,81.18
2024-01-26,Z0010,112259,111084,108847,23289,258,90.27,85558,78.6
2024-01-26,Z0094,121629,117499,110281,13447,196,68.61,96834,87.81
2024-01-26,Z0044,110409,106491,101949,24230,245,98.9,77719,76.23
2024-01-26,Z0066,105282,102279,98742,24780,273,90.77,73962,74.9
2024-01-26,Z0097,107138,102770,98512,30803,261,118.02,67709,68.73
2024-01-26,Z0087,114207,111796,105561,18025,176,102.42,87536,82.92
2024-01-26,Z0071,114845,110015,102884,25890,231,112.08,76994,74.84
2024-01-26,Z0112,120562,116102,110694,23456,203,115.55,87238,78.81
2024-01-26,Z0038,98697,96568,92489,18332,220,83.33,74157,80.18
2024-01-26,Z0085,93145,88903,80935,14165,187,75.75,66770,82.5
2024-01-26,Z0035,103100,101739,96019,32037,286,112.02,63982,66.63
2024-01-26,Z0090,94067,92968,89287,17115,184,93.02,72172,80.83
2024-01-26,Z0063,120728,116083,113031,23536,291,80.88,89495,79.18
2024-01-26,Z0095,92509,90589,83862,16868,153,110.25,66994,79.89
2024-01-26,Z0027,104670,99738,95609,22726,299,76.01,72883,76.23
2024-01-26,Z0023,128328,124085,118783,20525,197,104.19,98258,82.72
2024-01-26,Z0022,90719,89645,86352,12843,204,62.96,73509,85.13
2024-01-26,Z0096,116498,112825,106668,16196,237,68.34,90472,84.82
2024-01-26,Z0036,124917,122465,115496,22418,284,78.94,93078,80.59
2024-01-26,Z0041,104033,100032,96477,33786,289,116.91,62691,64.98
2024-01-26,Z0081,113097,111986,106954,18385,257,71.54,88569,82.81
2024-01-26,Z0082,113525,112065,109179,26563,251,105.83,82616,75.67
2024-01-26,Z0079,101725,96789,93674,21336,252,84.67,72338,77.22
2024-01-26,Z0033,127383,125572,121648,20371,223,91.35,101277,83.25
2024-01-26,Z0020,105733,103129,100203,30583,257,119.0,69620,69.48
2024-01-26,Z0064,127420,123724,119443,22193,220,100.88,97250,81.42
2024-01-26,Z0099,99247,94887,88213,16205,268,60.47,72008,81.63
2024-01-26,Z0075,124929,121678,118626,20247,194,104.37,98379,82.93
2024-01-26,Z0042,121362,119889,115145,23025,275,83.73,92120,80.0
2024-01-26,Z0057,102061,100157,93676,10138,164,61.82,83538,89.18
2024-01-26,Z0055,111059,108499,102737,21905,250,87.62,80832,78.68
2024-01-26,Z0049,107548,103758,96339,10340,152,68.03,85999,89.27
2024-01-26,Z0072,125490,122132,119662,14972,223,67.14,104690,87.49
2024-01-27,Z0017,120337,117869,115061,20027,225,89.01,95034,82.59
2024-01-27,Z0050,114747,111124,104998,28579,294,97.21,76419,72.78
2024-01-27,Z0060,106363,105317,99092,30305,269,112.66,68787,69.42
2024-01-27,Z0076,127841,122925,119280,22208,287,77.38,97072,81.38
2024-01-27,Z0003,90767,85872,83190,12660,166,76.27,70530,84.78
2024-01-27,Z0109,105332,101999,96857,22528,218,103.34,74329,76.74
2024-01-27,Z0001,108174,105697,102812,20892,286,73.05,81920,79.68
2024-01-27,Z0011,126674,125278,121740,14188,170,83.46,107552,88.35
2024-01-27,Z0108,92073,90761,83077,17181,153,112.3,65896,79.32
2024-01-27,Z0043,107194,103959,99102,13172,152,86.66,85930,86.71
2024-01-27,Z0026,124800,122293,115748,16020,250,64.08,99728,86.16
2024-01-27,Z0093,100762,97868,90395,16548,203,81.52,73847,81.69
2024-01-27,Z0024,129897,126192,123596,18523,205,90.36,105073,85.01
2024-01-27,Z0019,92147,90532,87585,12377,189,65.49,75208,85.87
2024-01-27,Z0088,128445,126890,120517,21584,195,110.69,98933,82.09
2024-01-27,Z0077,92013,87316,84826,15690,155,101.23,69136,81.5
2024-01-27,Z0040,127755,126214,122927,24338,248,98.14,98589,80.2
2024-01-27,Z0107,99825,98001,93075,9149,151,60.59,83926,90.17
2024-01-27,Z0008,105635,101076,94700,17148,215,79.76,77552,81.89
2024-01-27,Z0009,99490,97718,91751,13380,171,78.25,78371,85.42
2024-01-27,Z0111,94423,91165,84147,16770,216,77.64,67377,80.07
2024-01-27,Z0103,124841,121767,119066,29946,289,103.62,89120,74.85
2024-01-27,Z0061,121826,118907,114447,25888,233,111.11,88559,77.38
2024-01-27,Z0028,102454,97683,91419,11908,162,73.51,79511,86.97
2024-01-27,Z0029,114530,113302,110936,14794,161,91.89,96142,86.66
2024-01-27,Z0037,98719,96929,91211,20617,246,83.81,70594,77.4
2024-01-27,Z0074,118185,113250,106631,25124,267,94.1,81507,76.44
2024-01-27,Z0051,111575,108907,104754,16278,184,88.47,88476,84.46
2024-01-27,Z0098,129643,126735,121723,14029,154,91.1,107694,88.47
2024-01-27,Z0073,97856,95551,89323,31168,275,113.34,58155,65.11
2024-01-27,Z0083,125790,122474,116991,28097,287,97.9,88894,75.98
2024-01-27,Z0053,100912,98270,90286,13623,216,63.07,76663,84.91
2024-01-27,Z0104,91770,90753,86976,19479,224,86.96,67497,77.6
2024-01-27,Z0045,102404,100607,95392,24892,215,115.78,70500,73.91
2024-01-27,Z0105,129462,125486,119749,13413,169,79.37,106336,88.8
2024-01-27,Z0089,116287,114535,110066,19652,289,68.0,90414,82.15
2024-01-27,Z0069,124160,120467,115862,25666,294,87.3,90196,77.85
2024-01-27,Z0002,104385,102708,100603,22438,219,102.46,78165,77.7
2024-01-27,Z0046,111137,108191,100647,23344,240,97.27,77303,76.81
2024-01-27,Z0034,103275,99386,91482,31800,279,113.98,59682,65.24
2024-01-27,Z0025,124550,123105,117848,15573,233,66.84,102275,86.79
2024-01-27,Z0100,96213,93216,86347,28835,262,110.06,57512,66.61
2024-01-27,Z0091,110390,107715,104593,19558,198,98.78,85035,81.3
2024-01-27,Z0006,93981,91680,83998,18538,171,108.41,65460,77.93
2024-01-27,Z0062,95782,93839,87289,17500,282,62.06,69789,79.95
2024-01-27,Z0092,119799,117854,115254,17325,267,64.89,97929,84.97
2024-01-27,Z0059,112760,110343,106819,19751,213,92.73,87068,81.51
2024-01-27,Z0110,116120,115042,109919,27608,272,101.5,82311,74.88
2024-01-27,Z0068,115473,111505,104629,16913,231,73.22,87716,83.84
2024-01-27,Z0101,98417,96343,93134,10932,165,66.26,82202,88.26
2024-01-27,Z0018,127921,126119,119282,27819,247,112.63,91463,76.68
2024-01-27,Z0070,108562,104492,99813,24304,243,100.02,75509,75.65
2024-01-27,Z0065,97610,93725,88919,23845,208,114.64,65074,73.18
2024-01-27,Z0058,105791,104088,99544,27011,241,112.08,72533,72.87
2024-01-27,Z0067,128290,124920,119639,20280,194,104.54,99359,83.05
2024-01-27,Z0048,94710,93382,85891,18945,240,78.94,66946,77.94
2024-01-27,Z0031,128347,127215,120285,24013,277,86.69,96272,80.04
2024-01-27,Z0086,96794,95674,88103,14817,196,75.6,73286,83.18
2024-01-27,Z0052,110608,106446,100771,15558,187,83.2,85213,84.56
2024-01-27,Z0030,108460,104691,97048,22240,202,110.1,74808,77.08
2024-01-27,Z0080,101560,99407,96091,13149,197,66.75,82942,86.32
2024-01-27,Z0084,122463,118472,113302,33158,286,115.94,80144,70.73
2024-01-27,Z0032,123123,121985,118459,19245,274,70.24,99214,83.75
2024-01-27,Z0078,90028,88098,85085,22533,188,119.86,62552,73.52
2024-01-27,Z0005,92024,90726,82887,16317,152,107.35,66570,80.31
2024-01-27,Z0007,103503,100808,96697,20619,178,115.84,76078,78.68
2024-01-27,Z0012,107138,105369,99634,29492,246,119.89,70142,70.4
2024-01-27,Z0021,119505,116292,112386,14359,170,84.47,98027,87.22
2024-01-27,Z0039,97961,95397,92179,29753,251,118.54,62426,67.72
2024-01-27,Z0054,102031,98191,94731,15722,240,65.51,79009,83.4
2024-01-27,Z0047,105682,101109,95124,25682,260,98.78,69442,73.0
2024-01-27,Z0016,97766,95594,88738,22902,248,92.35,65836,74.19
2024-01-27,Z0014,119504,117076,110698,26729,252,106.07,83969,75.85
2024-01-27,Z0004,110858,109661,104599,16579,192,86.35,88020,84.15
2024-01-27,Z0015,93071,91516,89161,13163,200,65.82,75998,85.24
2024-01-27,Z0106,91040,87354,80880,28074,275,102.09,52806,65.29
2024-01-27,Z0056,125321,122542,115548,24307,218,111.5,91241,78.96
2024-01-27,Z0102,106459,105229,97394,12165,159,76.51,85229,87.51
2024-01-27,Z0013,95057,90738,86389,14966,234,63.96,71423,82.68
2024-01-27,Z0010,109157,105895,100666,25147,219,114.83,75519,75.02
2024-01-27,Z0094,107492,106226,99038,24827,280,88.67,74211,74.93
2024-01-27,Z0044,119680,117719,112944,24597,239,102.92,88347,78.22
2024-01-27,Z0066,126766,125094,119417,13814,175,78.94,105603,88.43
2024-01-27,Z0097,95796,92634,90604,16290,164,99.33,74314,82.02
2024-01-27,Z0087,114074,111708,108308,9108,150,60.72,99200,91.59
2024-01-27,Z0071,119825,118209,111575,17051,152,112.18,94524,84.72
2024-01-27,Z0112,92786,88713,85843,28882,244,118.37,56961,66.35
2024-01-27,Z0038,126964,122360,118948,18286,204,89.64,100662,84.63
2024-01-27,Z0085,125507,123567,121227,21553,215,100.25,99674,82.22
2024-01-27,Z0035,119715,115389,109256,17848,239,74.68,91408,83.66
2024-01-27,Z0090,107043,104010,100450,27692,251,110.33,72758,72.43
2024-01-27,Z0063,93457,90801,85826,23362,288,81.12,62464,72.78
2024-01-27,Z0095,99241,97788,94084,22885,246,93.03,71199,75.68
2024-01-27,Z0027,111826,108042,105224,17046,213,80.03,88178,83.8
2024-01-27,Z0023,94868,93856,87877,25835,264,97.86,62042,70.6
2024-01-27,Z0022,114111,112191,105271,24710,234,105.6,80561,76.53
2024-01-27,Z0096,129243,124566,120549,15351,169,90.84,105198,87.27
2024-01-27,Z0036,97957,93015,89787,16824,195,86.28,72963,81.26
2024-01-27,Z0041,94792,91058,84013,22455,242,92.79,61558,73.27
2024-01-27,Z0081,106251,102383,97868,16568,164,101.03,81300,83.07
2024-01-27,Z0082,124206,123138,117595,27250,287,94.95,90345,76.83
2024-01-27,Z0079,129111,125848,121879,25689,229,112.18,96190,78.92
2024-01-27,Z0033,90211,88704,81087,18330,258,71.05,62757,77.39
2024-01-27,Z0020,129795,128464,125914,27464,235,116.87,98450,78.19
2024-01-27,Z0064,112104,110163,107436,14774,242,61.05,92662,86.25
2024-01-27,Z0099,111359,107497,102254,19543,163,119.9,82711,80.89
2024-01-27,Z0075,127863,125342,120605,17102,222,77.04,103503,85.82
2024-01-27,Z0042,104842,100803,97794,18348,240,76.45,79446,81.24
2024-01-27,Z0057,124318,122515,116435,20659,239,86.44,95776,82.26
2024-01-27,Z0055,105567,104399,98998,19312,198,97.54,79686,80.49
2024-01-27,Z0049,113831,111854,104430,23094,221,104.5,81336,77.89
2024-01-27,Z0072,110625,107827,101216,32032,282,113.59,69184,68.35
2024-01-28,Z0017,125929,124477,118322,15499,191,81.15,102823,86.9
2024-01-28,Z0050,115103,110805,107782,17886,176,101.63,89896,83.41
2024-01-28,Z0060,129385,126821,121087,21622,215,100.57,99465,82.14
2024-01-28,Z0076,121501,119399,116967,25849,266,97.18,91118,77.9
2024-01-28,Z0003,107560,102700,100300,23057,236,97.7,77243,77.01
2024-01-28,Z0109,117626,114393,109948,29802,274,108.77,80146,72.89
2024-01-28,Z0001,94700,90865,82959,21739,274,79.34,61220,73.8
2024-01-28,Z0011,97860,93430,85871,21591,202,106.89,64280,74.86
2024-01-28,Z0108,129500,125987,122214,25426,231,110.07,96788,79.2
2024-01-28,Z0043,97910,93351,85702,31350,299,104.85,54352,63.42
2024-01-28,Z0026,99120,96169,92196,29489,252,117.02,62707,68.01
2024-01-28,Z0093,104352,101798,97020,13086,214,61.15,83934,86.51
2024-01-28,Z0024,118997,117003,114391,17230,278,61.98,97161,84.94
2024-01-28,Z0019,117169,115574,108558,17777,254,69.99,90781,83.62
2024-01-28,Z0088,110823,107947,105089,20761,195,106.47,84328,80.24
2024-01-28,Z0077,95519,91230,88786,22288,194,114.89,66498,74.9
2024-01-28,Z0040,127085,122631,116679,11876,173,68.65,104803,89.82
2024-01-28,Z0107,102879,100849,97554,21816,184,118.57,75738,77.64
2024-01-28,Z0008,114290,112273,108210,17361,165,105.22,90849,83.96
2024-01-28,Z0009,91447,88402,81783,27670,293,94.44,54113,66.17
2024-01-28,Z0111,92850,88026,83958,17593,160,109.96,66365,79.05
2024-01-28,Z0103,101953,98678,94870,30280,264,114.7,64590,68.08
2024-01-28,Z0061,99503,95647,89592,18383,218,84.33,71209,79.48
2024-01-28,Z0028,128170,124719,121630,17260,287,60.14,104370,85.81
2024-01-28,Z0029,124440,119765,113233,28821,252,114.37,84412,74.55
2024-01-28,Z0037,94924,90943,84589,18193,208,87.47,66396,78.49
2024-01-28,Z0074,116579,113590,107392,17584,156,112.72,89808,83.63
2024-01-28,Z0051,103280,98642,91778,29210,250,116.84,62568,68.17
2024-01-28,Z0098,123989,120129,115856,17277,151,114.42,98579,85.09
2024-01-28,Z0073,117566,114056,111820,26059,281,92.74,85761,76.7
2024-01-28,Z0083,105385,103241,97988,31052,266,116.74,66936,68.31
2024-01-28,Z0053,93782,89921,87155,16151,177,91.25,71004,81.47
2024-01-28,Z0104,114094,109708,102622,13173,205,64.26,89449,87.16
2024-01-28,Z0045,109049,106290,100799,11738,179,65.58,89061,88.36
2024-01-28,Z0105,93513,92018,84875,19552,229,85.38,65323,76.96
2024-01-28,Z0089,128590,125041,119111,14216,214,66.43,104895,88.06
2024-01-28,Z0069,124840,120582,118245,13563,200,67.82,104682,88.53
2024-01-28,Z0002,117684,114867,112731,26629,256,104.02,86102,76.38
2024-01-28,Z0046,112754,111435,103476,16465,250,65.86,87011,84.09
2024-01-28,Z0034,99107,96902,88909,25046,217,115.42,63863,71.83
2024-01-28,Z0025,120805,116267,109246,27210,295,92.24,82036,75.09
2024-01-28,Z0100,106138,101268,94740,12426,170,73.1,82314,86.88
2024-01-28,Z0091,99190,96043,88958,18859,193,97.72,70099,78.8
2024-01-28,Z0006,102886,99436,97041,12439,188,66.17,84602,87.18
2024-01-28,Z0062,118174,116760,113822,20871,239,87.33,92951,81.66
2024-01-28,Z0092,125278,123738,120089,20754,229,90.63,99335,82.72
2024-01-28,Z0059,110074,107129,101694,18978,222,85.49,82716,81.34
2024-01-28,Z0110,125969,124886,118520,13824,198,69.82,104696,88.34
2024-01-28,Z0068,119059,117846,112609,34570,291,118.8,78039,69.3
2024-01-28,Z0101,122826,120201,115271,18247,248,73.58,97024,84.17
2024-01-28,Z0018,111322,107351,103824,10029,151,66.42,93795,90.34
2024-01-28,Z0070,104017,102895,97176,31173,272,114.61,66003,67.92
2024-01-28,Z0065,99628,97466,92166,25461,293,86.9,66705,72.37
2024-01-28,Z0058,126113,122627,120066,15274,178,85.81,104792,87.28
2024-01-28,Z0067,110365,107200,103463,12657,161,78.62,90806,87.77
2024-01-28,Z0048,99096,94542,88052,15157,230,65.9,72895,82.79
2024-01-28,Z0031,117499,112968,107062,21077,181,116.45,85985,80.31
2024-01-28,Z0086,90294,85430,83410,26949,230,117.17,56461,67.69
2024-01-28,Z0052,122649,118407,115369,26583,255,104.25,88786,76.96
2024-01-28,Z0030,128098,126539,123430,28022,249,112.54,95408,77.3
2024-01-28,Z0080,93771,92400,85487,24208,211,114.73,61279,71.68
2024-01-28,Z0084,107558,105394,102302,19111,274,69.75,83191,81.32
2024-01-28,Z0032,116567,115047,108581,23050,292,78.94,85531,78.77
2024-01-28,Z0078,111922,110822,104066,18814,228,82.52,85252,81.92
2024-01-28,Z0005,113495,112253,107453,20203,231,87.46,87250,81.2
2024-01-28,Z0007,110991,107095,102493,22207,224,99.14,80286,78.33
2024-01-28,Z0012,116849,114308,109543,25184,263,95.76,84359,77.01
2024-01-28,Z0021,127259,125648,120565,13370,213,62.77,107195,88.91
2024-01-28,Z0039,124625,122856,119434,29215,255,114.57,90219,75.54
2024-01-28,Z0054,114982,111010,107138,18451,169,109.18,88687,82.78
2024-01-28,Z0047,128367,124673,120404,14974,206,72.69,105430,87.56
2024-01-28,Z0016,128043,126390,123209,26738,268,99.77,96471,78.3
2024-01-28,Z0014,127840,125401,120348,17884,241,74.21,102464,85.14
2024-01-28,Z0004,122069,118651,111188,14156,157,90.17,97032,87.27
2024-01-28,Z0015,117909,113555,108658,19215,282,68.14,89443,82.32
2024-01-28,Z0106,101095,99867,93908,22864,194,117.86,71044,75.65
2024-01-28,Z0056,116469,114156,111086,18834,181,104.06,92252,83.05
2024-01-28,Z0102,99166,96428,91143,14258,216,66.01,76885,84.36
2024-01-28,Z0013,125863,124543,120222,19394,178,108.96,100828,83.87
2024-01-28,Z0010,90555,88712,81280,11733,179,65.55,69547,85.56
2024-01-28,Z0094,91386,89719,84672,33167,279,118.88,51505,60.83
2024-01-28,Z0044,100619,96861,92857,18438,217,84.97,74419,80.14
2024-01-28,Z0066,97637,95892,89122,33167,290,114.37,55955,62.78
2024-01-28,Z0097,116739,113087,105926,12905,204,63.26,93021,87.82
2024-01-28,Z0087,100618,95825,91312,17911,279,64.2,73401,80.38
2024-01-28,Z0071,110187,106860,104243,18901,190,99.48,85342,81.87
2024-01-28,Z0112,108549,104241,101249,17073,180,94.85,84176,83.14
2024-01-28,Z0038,128192,125815,119434,20818,279,74.62,98616,82.57
2024-01-28,Z0085,121047,116873,110091,24991,226,110.58,85100,77.3
2024-01-28,Z0035,115881,113417,106584,13204,207,63.79,93380,87.61
2024-01-28,Z0090,109462,105776,100793,23171,223,103.91,77622,77.01
2024-01-28,Z0063,121933,119039,114516,22540,276,81.67,91976,80.32
2024-01-28,Z0095,99677,96577,89996,11498,179,64.24,78498,87.22
2024-01-28,Z0027,101907,99394,95393,24588,267,92.09,70805,74.22
2024-01-28,Z0023,112936,110906,107141,17997,290,62.06,89144,83.2
2024-01-28,Z0022,123988,122154,115183,22445,206,108.96,92738,80.51
2024-01-28,Z0096,102537,99598,95980,16299,202,80.69,79681,83.02
2024-01-28,Z0036,99455,96028,93157,22413,198,113.2,70744,75.94
2024-01-28,Z0041,90834,86292,81470,15648,160,97.8,65822,80.79
2024-01-28,Z0081,124492,120990,116577,20254,295,68.66,96323,82.63
2024-01-28,Z0082,99505,96608,90110,15617,253,61.73,74493,82.67
2024-01-28,Z0079,92105,88537,81114,21695,193,112.41,59419,73.25
2024-01-28,Z0033,127679,124459,122226,21229,263,80.72,100997,82.63
2024-01-28,Z0020,123560,120653,112944,21700,274,79.2,91244,80.79
2024-01-28,Z0064,105762,101652,97486,17728,157,112.92,79758,81.81
2024-01-28,Z0099,105898,103259,96066,30570,260,117.58,65496,68.18
2024-01-28,Z0075,91214,89891,82005,17413,169,103.04,64592,78.77
2024-01-28,Z0042,122980,120322,114244,14180,168,84.41,100064,87.59
2024-01-28,Z0057,127792,126041,122624,19010,277,68.63,103614,84.5
2024-01-28,Z0055,112301,110256,106462,18508,189,97.93,87954,82.62
2024-01-28,Z0049,128756,127652,120067,15368,176,87.32,104699,87.2
2024-01-28,Z0072,128346,125891,119026,19938,277,71.98,99088,83.25
2024-01-29,Z0017,118469,113624,107934,15753,182,86.56,92181,85.4
2024-01-29,Z0050,113290,110331,105039,18199,246,73.98,86840,82.67
2024-01-29,Z0060,123146,118853,113524,14270,172,82.97,99254,87.43
2024-01-29,Z0076,106608,103871,101134,17799,245,72.65,83335,82.4
2024-01-29,Z0003,106619,105437,102726,24367,282,86.41,78359,76.28
2024-01-29,Z0109,112372,107543,103655,29206,266,109.8,74449,71.82
2024-01-29,Z0001,119294,115217,111958,16775,175,95.86,95183,85.02
2024-01-29,Z0011,111630,107455,104707,10003,162,61.75,94704,90.45
2024-01-29,Z0108,102178,97627,95118,22243,256,86.89,72875,76.62
2024-01-29,Z0043,91823,88067,81187,12067,167,72.26,69120,85.14
2024-01-29,Z0026,101133,97310,91078,20531,179,114.7,70547,77.46
2024-01-29,Z0093,129287,126153,122376,17002,188,90.44,105374,86.11
2024-01-29,Z0024,114014,110530,103101,32087,279,115.01,71014,68.88
2024-01-29,Z0019,108161,105857,98998,22282,195,114.27,76716,77.49
2024-01-29,Z0088,114502,110513,108362,26295,255,103.12,82067,75.73
2024-01-29,Z0077,122737,120412,117111,21463,221,97.12,95648,81.67
2024-01-29,Z0040,98998,97764,93042,14581,166,87.84,78461,84.33
2024-01-29,Z0107,94656,92331,86198,24068,219,109.9,62130,72.08
2024-01-29,Z0008,115735,111866,105350,13827,155,89.21,91523,86.88
2024-01-29,Z0009,91242,89895,86064,28290,289,97.89,57774,67.13
2024-01-29,Z0111,118511,114361,110443,19480,171,113.92,90963,82.36
2024-01-29,Z0103,93232,88474,80477,16685,253,65.95,63792,79.27
2024-01-29,Z0061,100972,96892,93068,25380,290,87.52,67688,72.73
2024-01-29,Z0028,100683,96499,90439,30617,287,106.68,59822,66.15
2024-01-29,Z0029,123172,120451,113135,11039,158,69.87,102096,90.24
2024-01-29,Z0037,101017,96172,89962,31022,279,111.19,58940,65.52
2024-01-29,Z0074,101384,98708,96644,23192,200,115.96,73452,76.0
2024-01-29,Z0051,99491,97667,94252,16751,184,91.04,77501,82.23
2024-01-29,Z0098,90968,89600,87368,29942,269,111.31,57426,65.73
2024-01-29,Z0073,125010,123104,118021,19704,296,66.57,98317,83.3
2024-01-29,Z0083,115496,113808,107536,19754,252,78.39,87782,81.63
2024-01-29,Z0053,120936,118902,115433,33239,282,117.87,82194,71.2
2024-01-29,Z0104,127493,126330,120708,27823,270,103.05,92885,76.95
2024-01-29,Z0045,100292,97027,91238,27913,278,100.41,63325,69.41
2024-01-29,Z0105,107207,102776,96625,17969,212,84.76,78656,81.4
2024-01-29,Z0089,126981,123034,120237,10419,161,64.72,109818,91.33
2024-01-29,Z0069,123547,119484,114634,17152,279,61.48,97482,85.04
2024-01-29,Z0002,109276,105025,97491,14421,173,83.36,83070,85.21
2024-01-29,Z0046,116469,112163,107261,29820,249,119.76,77441,72.2
2024-01-29,Z0034,122563,120460,114742,15053,207,72.72,99689,86.88
2024-01-29,Z0025,90021,87521,84679,24723,292,84.67,59956,70.8
2024-01-29,Z0100,105799,103039,97398,22060,191,115.5,75338,77.35
2024-01-29,Z0091,111596,110405,103291,14767,223,66.22,88524,85.7
2024-01-29,Z0006,98587,94509,87395,16607,213,77.97,70788,81.0
2024-01-29,Z0062,94662,93432,90559,21676,215,100.82,68883,76.06
2024-01-29,Z0092,117197,115958,113869,22302,264,84.48,91567,80.41
2024-01-29,Z0059,115032,111752,105303,12385,178,69.58,92918,88.24
2024-01-29,Z0110,120028,118590,111096,23726,227,104.52,87370,78.64
2024-01-29,Z0068,105651,104307,99596,12349,197,62.69,87247,87.6
2024-01-29,Z0101,96273,93085,88623,21165,216,97.99,67458,76.12
2024-01-29,Z0018,115692,114067,107688,24225,295,82.12,83463,77.5
2024-01-29,Z0070,116555,111561,107883,16057,236,68.04,91826,85.12
2024-01-29,Z0065,107127,105665,102097,17980,214,84.02,84117,82.39
2024-01-29,Z0058,101539,98834,91575,17431,255,68.36,74144,80.97
2024-01-29,Z0067,104692,101956,94814,17182,193,89.03,77632,81.88
2024-01-29,Z0048,118615,113808,107857,19002,166,114.47,88855,82.38
2024-01-29,Z0031,105629,101723,99059,30668,280,109.53,68391,69.04
2024-01-29,Z0086,107740,105726,101594,21120,195,108.31,80474,79.21
2024-01-29,Z0052,100860,98806,95042,16862,218,77.35,78180,82.26
2024-01-29,Z0030,96009,94647,89778,11355,160,70.97,78423,87.35
2024-01-29,Z0080,123435,119065,111089,16557,240,68.99,94532,85.1
2024-01-29,Z0084,110454,106568,104147,20407,243,83.98,83740,80.41
2024-01-29,Z0032,128367,123717,117560,31051,264,117.62,86509,73.59
2024-01-29,Z0078,115708,113006,107386,16228,180,90.16,91158,84.89
2024-01-29,Z0005,93190,89133,86536,16426,270,60.84,70110,81.02
2024-01-29,Z0007,122125,120734,117659,15458,254,60.86,102201,86.86
2024-01-29,Z0012,125418,123106,118722,15093,151,99.96,103629,87.29
2024-01-29,Z0021,105563,100612,95303,13685,170,80.5,81618,85.64
2024-01-29,Z0039,111885,107147,103988,20491,234,87.57,83497,80.29
2024-01-29,Z0054,113958,111427,103946,13509,210,64.33,90437,87.0
2024-01-29,Z0047,113932,112052,104357,15693,174,90.19,88664,84.96
2024-01-29,Z0016,114829,110281,105096,15596,175,89.12,89500,85.16
2024-01-29,Z0014,128931,125356,118092,21362,216,98.9,96730,81.91
2024-01-29,Z0004,105890,102467,96892,22320,200,111.6,74572,76.96
2024-01-29,Z0015,98071,96906,93333,28649,296,96.79,64684,69.3
2024-01-29,Z0106,105540,101632,94920,24254,206,117.74,70666,74.45
2024-01-29,Z0056,116201,111203,105320,23793,225,105.75,81527,77.41
2024-01-29,Z0102,109899,105496,98898,12990,171,75.97,85908,86.87
2024-01-29,Z0013,112606,111022,107064,27255,280,97.34,79809,74.54
2024-01-29,Z0010,110393,106658,100167,19031,218,87.3,81136,81.0
2024-01-29,Z0094,117750,116349,113375,10786,165,65.37,102589,90.49
2024-01-29,Z0044,106607,105090,102855,17507,225,77.81,85348,82.98
2024-01-29,Z0066,118074,116959,111725,22144,188,117.79,89581,80.18
2024-01-29,Z0097,116853,115672,112331,29359,261,112.49,82972,73.86
2024-01-29,Z0087,126495,124080,118152,18907,286,66.11,99245,84.0
2024-01-29,Z0071,120815,118922,110945,26860,277,96.97,84085,75.79
2024-01-29,Z0112,112942,109916,107523,12139,164,74.02,95384,88.71
2024-01-29,Z0038,99716,98113,95532,16207,212,76.45,79325,83.04
2024-01-29,Z0085,90132,86294,80909,25069,223,112.42,55840,69.02
2024-01-29,Z0035,126538,123270,120295,16455,198,83.11,103840,86.32
2024-01-29,Z0090,97213,94400,89137,14628,153,95.61,74509,83.59
2024-01-29,Z0063,116119,111669,106834,16166,209,77.35,90668,84.87
2024-01-29,Z0095,92738,90381,84247,18784,178,105.53,65463,77.7
2024-01-29,Z0027,115892,112155,109994,15465,163,94.88,94529,85.94
2024-01-29,Z0023,105690,102781,99654,19816,182,108.88,79838,80.12
2024-01-29,Z0022,104496,99626,95968,26010,294,88.47,69958,72.9
2024-01-29,Z0096,117701,114738,107585,26702,291,91.76,80883,75.18
2024-01-29,Z0036,100481,98515,95626,18112,168,107.81,77514,81.06
2024-01-29,Z0041,109445,106080,100451,24482,226,108.33,75969,75.63
2024-01-29,Z0081,113351,108633,103444,20005,182,109.92,83439,80.66
2024-01-29,Z0082,100940,98274,93208,15910,167,95.27,77298,82.93
2024-01-29,Z0079,114485,110202,106761,19101,166,115.07,87660,82.11
2024-01-29,Z0033,91067,89940,85017,23573,219,107.64,61444,72.27
2024-01-29,Z0020,99018,94553,86567,22917,250,91.67,63650,73.53
2024-01-29,Z0064,105187,103676,97691,16575,223,74.33,81116,83.03
2024-01-29,Z0099,109563,106297,99759,15532,234,66.38,84227,84.43
2024-01-29,Z0075,108608,105333,101607,20548,293,70.13,81059,79.78
2024-01-29,Z0042,116582,113887,111621,20045,276,72.63,91576,82.04
2024-01-29,Z0057,107221,102771,96187,12384,156,79.39,83803,87.13
2024-01-29,Z0055,107070,102709,95618,15361,165,93.1,80257,83.94
2024-01-29,Z0049,127415,124605,118187,12543,161,77.91,105644,89.39
2024-01-29,Z0072,100420,96874,91483,20048,170,117.93,71435,78.09
2024-01-30,Z0017,118754,115404,109047,11797,166,71.07,97250,89.18
2024-01-30,Z0050,111263,109040,102031,24754,283,87.47,77277,75.74
2024-01-30,Z0060,92739,90796,86066,30846,297,103.86,55220,64.16
2024-01-30,Z0076,111168,106216,101773,29332,286,102.56,72441,71.18
2024-01-30,Z0003,99964,95755,88821,15592,210,74.25,73229,82.45
2024-01-30,Z0109,107261,103391,98191,20240,252,80.32,77951,79.39
2024-01-30,Z0001,102336,97589,92753,17508,150,116.72,75245,81.12
2024-01-30,Z0011,106676,104025,97394,20276,194,104.52,77118,79.18
2024-01-30,Z0108,115112,112186,107500,19092,175,109.1,88408,82.24
2024-01-30,Z0043,123001,120769,116117,21305,195,109.26,94812,81.65
2024-01-30,Z0026,104429,101055,96783,14247,180,79.15,82536,85.28
2024-01-30,Z0093,107350,105461,99598,12032,178,67.6,87566,87.92
2024-01-30,Z0024,112538,108138,106104,15130,166,91.15,90974,85.74
2024-01-30,Z0019,127310,122787,119024,20176,173,116.63,98848,83.05
2024-01-30,Z0088,93291,89803,85103,19819,240,82.58,65284,76.71
2024-01-30,Z0077,124326,122732,118456,11236,181,62.08,107220,90.51
2024-01-30,Z0040,127207,125104,121685,19730,259,76.18,101955,83.79
2024-01-30,Z0107,95409,92931,87017,15681,175,89.61,71336,81.98
2024-01-30,Z0008,119823,115050,110094,13265,213,62.28,96829,87.95
2024-01-30,Z0009,112401,110019,105445,23378,255,91.68,82067,77.83
2024-01-30,Z0111,109768,106646,103077,13453,202,66.6,89624,86.95
2024-01-30,Z0103,100086,96843,92977,17302,160,108.14,75675,81.39
2024-01-30,Z0061,106412,104707,101687,25808,249,103.65,75879,74.62
2024-01-30,Z0028,100255,97809,92145,20447,296,69.08,71698,77.81
2024-01-30,Z0029,105764,101777,94022,18010,250,72.04,76012,80.84
2024-01-30,Z0037,126370,124404,118719,16443,178,92.38,102276,86.15
2024-01-30,Z0074,97244,93968,88600,15697,257,61.08,72903,82.28
2024-01-30,Z0051,109965,106203,100166,16121,164,98.3,84045,83.91
2024-01-30,Z0098,106956,102347,94645,13277,199,66.72,81368,85.97
2024-01-30,Z0073,123382,122057,116317,22486,208,108.11,93831,80.67
2024-01-30,Z0083,105210,103852,98075,19774,224,88.28,78301,79.84
2024-01-30,Z0053,128674,125303,121582,28402,272,104.42,93180,76.64
2024-01-30,Z0104,107733,103037,97141,30813,288,106.99,66328,68.28
2024-01-30,Z0045,129709,126207,118935,12268,199,61.65,106667,89.69
2024-01-30,Z0105,128014,126822,122148,33396,286,116.77,88752,72.66
2024-01-30,Z0089,110229,106652,104561,23749,257,92.41,80812,77.29
2024-01-30,Z0069,119011,116936,112423,20502,227,90.32,91921,81.76
2024-01-30,Z0002,98168,94403,91605,13876,224,61.95,77729,84.85
2024-01-30,Z0046,103750,98801,96197,17805,170,104.74,78392,81.49
2024-01-30,Z0034,92979,88935,82019,11178,164,68.16,70841,86.37
2024-01-30,Z0025,113184,111587,108055,21058,235,89.61,86997,80.51
2024-01-30,Z0100,113704,112191,104569,20688,265,78.07,83881,80.22
2024-01-30,Z0091,108261,103289,97446,20656,199,103.8,76790,78.8
2024-01-30,Z0006,124467,122438,115843,16411,218,75.28,99432,85.83
2024-01-30,Z0062,112164,110448,103211,19749,227,87.0,83462,80.87
2024-01-30,Z0092,103796,100148,97483,32181,270,119.19,65302,66.99
2024-01-30,Z0059,122694,117944,113736,24742,250,98.97,88994,78.25
2024-01-30,Z0110,104605,102526,100299,18635,295,63.17,81664,81.42
2024-01-30,Z0068,123837,121670,114943,25343,230,110.19,89600,77.95
2024-01-30,Z0101,124131,122719,118964,14201,155,91.62,104763,88.06
2024-01-30,Z0018,90519,88152,82608,24395,216,112.94,58213,70.47
2024-01-30,Z0070,100514,97114,94012,11569,161,71.86,82443,87.69
2024-01-30,Z0065,90597,87938,82665,15610,151,103.38,67055,81.12
2024-01-30,Z0058,128549,124944,120756,20688,230,89.95,100068,82.87
2024-01-30,Z0067,119401,117813,111341,17844,291,61.32,93497,83.97
2024-01-30,Z0048,114386,112636,105914,17044,219,77.83,88870,83.91
2024-01-30,Z0031,116205,114211,106532,11688,155,75.41,94844,89.03
2024-01-30,Z0086,111182,107673,103614,24138,237,101.85,79476,76.7
2024-01-30,Z0052,106043,104567,99581,12445,173,71.94,87136,87.5
2024-01-30,Z0030,90400,86545,82321,11785,196,60.13,70536,85.68
2024-01-30,Z0080,93412,92356,88481,12907,173,74.61,75574,85.41
2024-01-30,Z0084,127066,122298,114546,12664,193,65.62,101882,88.94
2024-01-30,Z0032,111217,110016,106663,16473,256,64.35,90190,84.56
2024-01-30,Z0078,116986,115095,108784,16401,273,60.08,92383,84.92
2024-01-30,Z0005,100794,96860,94838,28517,288,99.02,66321,69.93
2024-01-30,Z0007,100394,98185,93889,30970,265,116.87,62919,67.01
2024-01-30,Z0012,110800,107363,104930,15756,177,89.02,89174,84.98
2024-01-30,Z0021,127909,126037,120366,17457,173,100.91,102909,85.5
2024-01-30,Z0039,118312,114116,108077,17995,267,67.4,90082,83.35
2024-01-30,Z0054,108482,103683,98766,22772,281,81.04,75994,76.94
2024-01-30,Z0047,103026,100897,95633,10208,154,66.29,85425,89.33
2024-01-30,Z0016,95435,94134,90157,17092,247,69.2,73065,81.04
2024-01-30,Z0014,92763,88937,83696,23672,252,93.94,60024,71.72
2024-01-30,Z0004,125825,124275,116701,12089,175,69.08,104612,89.64
2024-01-30,Z0015,128179,125592,121770,15979,156,102.43,105791,86.88
2024-01-30,Z0106,128688,126524,121307,26162,241,108.56,95145,78.43
2024-01-30,Z0056,101688,100375,94096,16720,252,66.35,77376,82.23
2024-01-30,Z0102,95783,94071,89896,13590,202,67.28,76306,84.88
2024-01-30,Z0013,128174,123280,117208,18045,281,64.22,99163,84.6
2024-01-30,Z0010,102041,98294,93861,21436,257,83.41,72425,77.16
2024-01-30,Z0094,126069,124799,121005,13977,156,89.6,107028,88.45
2024-01-30,Z0044,119482,116020,109727,19455,216,90.07,90272,82.27
2024-01-30,Z0066,101586,99507,94629,21507,260,82.72,73122,77.27
2024-01-30,Z0097,95322,90468,82728,20656,297,69.55,62072,75.03
2024-01-30,Z0087,119299,117696,110439,27037,273,99.04,83402,75.52
2024-01-30,Z0071,99777,95720,88714,18023,216,83.44,70691,79.68
2024-01-30,Z0112,110369,108776,105381,18974,259,73.26,86407,81.99
2024-01-30,Z0038,118264,116665,114152,30911,296,104.43,83241,72.92
2024-01-30,Z0085,112375,109244,106178,16727,197,84.91,89451,84.25
2024-01-30,Z0035,97833,93947,89294,13301,190,70.01,75993,85.1
2024-01-30,Z0090,105754,103666,97281,17958,174,103.21,79323,81.54
2024-01-30,Z0063,121095,119327,114813,24006,257,93.41,90807,79.09
2024-01-30,Z0095,126737,122453,115887,13242,188,70.44,102645,88.57
2024-01-30,Z0027,92196,91109,88320,18242,229,79.66,70078,79.35
2024-01-30,Z0023,109859,105706,102042,18736,223,84.02,83306,81.64
2024-01-30,Z0022,124077,119624,116760,28762,296,97.17,87998,75.37
2024-01-30,Z0096,102055,99762,94399,29968,272,110.18,64431,68.25
2024-01-30,Z0036,101978,100955,95952,25365,287,88.38,70587,73.56
2024-01-30,Z0041,107615,102752,96964,11867,171,69.4,85097,87.76
2024-01-30,Z0081,129349,124740,117939,22280,254,87.72,95659,81.11
2024-01-30,Z0082,120031,118610,114837,9520,151,63.05,105317,91.71
2024-01-30,Z0079,101760,98126,95180,10205,155,65.84,84975,89.28
2024-01-30,Z0033,115762,112928,109364,22032,272,81.0,87332,79.85
2024-01-30,Z0020,94944,90175,82490,16624,260,63.94,65866,79.85
2024-01-30,Z0064,119990,116901,112954,24330,250,97.32,88624,78.46
2024-01-30,Z0099,124076,120090,117704,27212,246,110.62,90492,76.88
2024-01-30,Z0075,93258,90233,83422,30252,276,109.61,53170,63.74
2024-01-30,Z0042,112958,109357,103424,26796,296,90.53,76628,74.09
2024-01-30,Z0057,105775,101928,95407,15422,150,102.82,79985,83.84
2024-01-30,Z0055,124207,121134,115692,15773,182,86.67,99919,86.37
2024-01-30,Z0049,90055,85731,83626,20282,181,112.06,63344,75.75
2024-01-30,Z0072,125969,122073,119404,25335,275,92.13,94069,78.78
